key	text	tooltip
#Loc;1;text/db/effects/effect_side_building.loc		
effects_description_ironic_unit_unlock_region	This building unlocks units to be recruited in this province.	false
effects_description_ironic_unit_unlock_bing_earth_auxilia_xiongnu_raiders	Xiongnu Ravagers (Rank 3) available for recruitment	false
effects_description_ironic_unit_unlock_bing_water_auxilia_xianbei_skirmishers	Heishan Cavalry (Rank 6) available for recruitment	false
effects_description_ironic_unit_unlock_ji_metal_jizhou_elite_swordguards	Jizhou Noble Bodyguards (Rank 6) available for recruitment	false
effects_description_ironic_unit_unlock_ji_wood_cavalrybane_infantry	Cangting Rearguards (Rank 3) available for recruitment	false
effects_description_ironic_unit_unlock_jiao_metal_blades_of_the_south	Warriors of the Pearl (Rank 3) available for recruitment	false
effects_description_ironic_unit_unlock_jiao_wood_headcrushers	Jiaozhou Linebreakers (Rank 3) available for recruitment	false
effects_description_ironic_unit_unlock_jing_earth_northern_nobles	Jingzhou Noble Guards (Rank 6) available for recruitment	false
effects_description_ironic_unit_unlock_jing_metal_sword_saints	Chu Blademasters (Rank 6) available for recruitment	false
effects_description_ironic_unit_unlock_liang_metal_xiliang_macemen	Xiliang Hammer Guard (Rank 3) available for recruitment	false
effects_description_ironic_unit_unlock_liang_wood_xiliang_spearmen	Western Border Guards (Rank 3) available for recruitment	false
effects_description_ironic_unit_unlock_qing_earth_bookish_cavaliers	Sages of the Analects (Rank 3) available for recruitment	false
effects_description_ironic_unit_unlock_qing_water_thunderous_repeaters	Storms of Lu (Rank 6) available for recruitment	false
effects_description_ironic_unit_unlock_sili_wood_brave_protectors	Feathered Forest Warriors (Rank 6) available for recruitment	false
effects_description_ironic_unit_unlock_sili_wood_dynasty_warriors	Warriors of the Western Garden (Rank 3) available for recruitment	false
effects_description_ironic_unit_unlock_xu_water_coastal_homeguard	Shields of Xiapi (Rank 3) available for recruitment	false
effects_description_ironic_unit_unlock_xu_wood_valiant_vigilantes	Guangling Marines (Rank 6) available for recruitment	false
effects_description_ironic_unit_unlock_yan_water_river_guards	Dingtao Crossbowmen (Rank 1) available for recruitment	false
effects_description_ironic_unit_unlock_yan_wood_yellow_turban_remnants	Qingzhou Migrant Warriors (Rank 6) available for recruitment	false
effects_description_ironic_unit_unlock_yang_metal_yangtze_patrollers	Danyang Elite Spears (Rank 3) available for recruitment	false
effects_description_ironic_unit_unlock_yang_wood_yang_guardians	Yangzhou Marines (Rank 6) available for recruitment	false
effects_description_ironic_unit_unlock_yi_metal_forest_fighters	Guerilla of the Gorges (Rank 1) available for recruitment	false
effects_description_ironic_unit_unlock_yi_water_yizhou_stalkers	Flying Warriors (Rank 1) available for recruitment	false
effects_description_ironic_unit_unlock_yong_metal_defenders_of_capitals	Chencang Guardians (Rank 6) available for recruitment	false
effects_description_ironic_unit_unlock_yong_wood_downtrodden_refugees	Conscripted Convicts (Rank 1) available for recruitment	false
effects_description_ironic_unit_unlock_you_fire_auxiliary_wuhuan_raiders	Wusun Auxiliaries (Rank 6) available for recruitment	false
effects_description_ironic_unit_unlock_you_metal_fierce_northern_axemen	Youzhou Brutes (Rank 6) available for recruitment	false
effects_description_ironic_unit_unlock_yu_fire_firestarter_cavalry	Impetuous Lancers (Rank 6) available for recruitment	false
effects_description_ironic_unit_unlock_yu_metal_yuzhou_assault_infantry	Yuzhou Diehard Warriors (Rank 3) available for recruitment	false
effects_description_ironic_unit_unlock_metal_qiang_warriors	Qiang Warriors (Rank 1) available for recruitment	false
effects_description_ironic_unit_unlock_water_qiang_archers	Qiang Archers (Rank 1) available for recruitment	false
effects_description_ironic_unit_unlock_wood_qiang_polearms	Qiang Polearms (Rank 1) available for recruitment	false
effects_description_ironic_unit_unlock_earth_qiang_raiders	Qiang Raiders (Rank 3) available for recruitment	false
effects_description_ironic_unit_unlock_fire_qiang_marauders	Qiang Marauders (Rank 6) available for recruitment	false
effects_description_ironic_unit_unlock_water_qiang_hunters	Qiang Hunters (Rank 3) available for recruitment	false
effects_description_ironic_unit_unlock_metal_yue_remnant_warriors	Yue Remnant Warriors (Rank 3) available for recruitment	false
effects_description_ironic_unit_unlock_wood_yue_tribesmen	Yue Tribesmen (Rank 3) available for recruitment	false
effects_description_ironic_unit_unlock_fire_southern_elephants	Southern Elephants (Rank 6) available for recruitment	false
effects_description_ironic_unit_unlock_fire_war_elephants	War Elephants (Rank 6) available for recruitment	false
effects_description_ironic_unit_unlock_water_nanzhong_elephants	Nanzhong Elephants (Rank 6) available for recruitment	false
effects_description_ironic_unit_unlock_metal_axe_throwers	Axe Throwers (Rank 1) available for recruitment	false
effects_description_ironic_unit_unlock_metal_nanman_warriors	Nanman Warriors (Rank 1) available for recruitment	false
effects_description_ironic_unit_unlock_metal_valley_tribesmen	Valley Tribesmen (Rank 1) available for recruitment	false
effects_description_ironic_unit_unlock_water_fire_archers	Fire Archers (Rank 1) available for recruitment	false
effects_description_ironic_unit_unlock_water_javelin_throwers	Javelin Throwers (Rank 1) available for recruitment	false
effects_description_ironic_unit_unlock_wood_javelin_spearmen	Javelin Spearmen (Rank 1) available for recruitment	false
effects_description_ironic_unit_unlock_wood_nanman_spearmen	Nanman Spearmen (Rank 1) available for recruitment	false
effects_description_ironic_unit_unlock_earth_xiongnu_noble_cavalry	Xiongnu Noble Cavalry (Rank 3) available for recruitment	false
effects_description_ironic_unit_unlock_fire_heavy_xiliang_cavalry	Heavy Xiliang Cavalry (Rank 6) available for recruitment	false
effects_description_ironic_unit_unlock_fire_xiliang_cavalry	Xiliang Cavalry (Rank 3) available for recruitment	false
effects_description_ironic_unit_unlock_water_xiongnu_assassins	Xiongnu Assassins (Rank 6) available for recruitment	false
effects_description_ironic_unit_unlock_fire_xiongnu_cataphracts	Xiongnu Cataphracts (Rank 6) available for recruitment	false
effects_description_ironic_unit_unlock_fire_xiongnu_cavalry	Xiongnu Cavalry (Rank 3) available for recruitment	false
effects_description_ironic_unit_unlock_earth_wuhuan_cavalry	Wuhuan Axe Cavalry (Rank 6) available for recruitment	false
effects_description_ironic_unit_unlock_earth_xianbei_swordguard	Xianbei Swordguard Cavalry (Rank 3) available for recruitment	false
effects_description_ironic_unit_unlock_fire_wuhuan_dragons	Wuhuan Dragon (Rank 3) available for recruitment	false
effects_description_ironic_unit_unlock_metal_wuhuan_infantry	Wuhuan Infantry (Rank 3) available for recruitment	false
effects_description_ironic_unit_unlock_metal_xianbei_headhunters	Xianbei Headhunter (Rank 6) available for recruitment	false
effects_description_ironic_unit_unlock_water_wuhuan_archers	Wuhuan Archer Cavalry (Rank 6) available for recruitment	false
effects_description_ironic_unit_unlock_fire_xianbei_riders	Xianbei Riders (Rank 3) available for recruitment	false
effects_description_ironic_unit_unlock_water_xianbei_horse_archers	Xianbei Horse Archers (Rank 6) available for recruitment	false
effects_description_ironic_unit_unlock_metal_chu_infantry	Chu Infantry (Rank 3) available for recruitment	false
effects_description_ironic_unit_unlock_wood_chu_spearmen	Chu Spearmen (Rank 3) available for recruitment	false
effects_description_ironic_unit_unlock_cataphracts_fire	Di Cataphracts (Rank 6) available for recruitment	false
effects_description_ironic_unit_unlock_horse_archers_water	Di Horse Archers (Rank 3) available for recruitment	false
effects_description_ironic_unit_unlock_marauders_earth	Di Marauders (Rank 6) available for recruitment	false
effects_description_ironic_unit_unlock_raiders_fire	Di Raiders (Rank 3) available for recruitment	false
