key	text	tooltip
#Loc;1;text/ceo/general_items/@@ironic_ceo_titles.loc		
ceo_nodes_title_3k_main_ceo_node_career_historical_wang_kuang	Proprietor of Punishment	true
ceo_nodes_title_3k_main_ceo_career_historical_sheng_xian	Seeker of Sanctuary	true
ceo_nodes_title_3k_main_ceo_career_historical_cao_chun	Tiger and Leopard Commander	true
ceo_nodes_title_3k_main_ceo_career_historical_cao_hong	The Soaring Eagle	true
ceo_nodes_title_3k_main_ceo_career_historical_cao_xiu	Thousand Li Cao	true
ceo_nodes_title_3k_main_ceo_career_historical_cao_zhen	Warden of the West	true
ceo_nodes_title_3k_main_ceo_career_historical_cao_biao	The Red Tiger Prince	true
ceo_nodes_title_3k_main_ceo_career_historical_cao_jie	The Last Empress	true
ceo_nodes_title_3k_main_ceo_career_historical_cao_rui	Emperor Ming	true
ceo_nodes_title_3k_main_ceo_career_historical_cao_shuang	The Fallen Regent	true
ceo_nodes_title_3k_main_ceo_career_historical_cao_xi	The Ignored Brother	true
ceo_nodes_title_3k_main_ceo_career_historical_cao_zhang	Yellow Bearded Warrior	true
ceo_nodes_title_3k_main_ceo_career_historical_cao_zhi	Rhapsody in Seven Steps	true
ceo_nodes_title_3k_main_ceo_threshold_career_historical_guo_yuan	Consummate Professional	true
ceo_nodes_title_3k_main_ceo_threshold_career_historical_deng_sheng	Tenacious Defender	true
ceo_nodes_title_3k_main_ceo_threshold_career_historical_xia_zhao	Bulwark of Gu Pass	true
ceo_nodes_title_3k_main_ceo_threshold_career_historical_zuozhi_zhulan	Matriarch of the Mountains	true
ceo_nodes_title_3k_main_ceo_career_historical_tadun	The Storm of the Steppe	true
ceo_nodes_title_3k_main_ceo_career_historical_leipan	The Wolf Prince	true
ceo_nodes_title_3k_main_ceo_career_historical_wuyan	The Scourge of Liaoxi	true
ceo_nodes_title_3k_main_ceo_career_historical_supuyan	Farseeing Chieftain	true
ceo_nodes_title_3k_main_ceo_career_historical_wangdong	Liucheng Defender	true
ceo_nodes_title_3k_main_ceo_career_historical_gujin	Daling River Raider	true
ceo_nodes_title_3k_main_ceo_career_historical_gurudun	Wuhuan Vanguard	true
ceo_nodes_title_3k_main_ceo_career_historical_xianyu_fu	Avenging Warrior	true
ceo_nodes_title_3k_main_ceo_career_historical_huchuquan	The Last Chanyu	true
ceo_nodes_title_3k_main_ceo_career_historical_liu_bao	The Tuqi King	true
ceo_nodes_title_3k_main_ceo_career_historical_qubei	The Virtuous Prince	true
ceo_nodes_title_3k_main_threshold_ceo_career_historical_yufuluo	The Mercenary Chanyu	true
ceo_nodes_title_3k_main_ceo_career_historical_lian_zhi	Gentle Peacekeeper	true
ceo_nodes_title_3k_main_ceo_career_historical_gu_ruilan	Dismissive Beauty	true
ceo_nodes_title_3k_main_ceo_career_historical_geng_wu	Misplaced Loyalist	true
ceo_nodes_title_3k_main_ceo_career_historical_zhang_yanyan	Jewel of Bingzhou	true
ceo_nodes_title_3k_main_ceo_career_historical_fan_liyan	Steady Handed Mother	true
ceo_nodes_title_3k_main_ceo_career_historical_tian_chou	Intrepid Pathfinder	true
ceo_nodes_title_3k_main_ceo_career_historical_wei_you	Advocate of Pacifism 	true
ceo_nodes_title_3k_main_ceo_career_historical_liu_he	Hapless Heir	true
ceo_nodes_title_3k_main_ceo_career_historical_ju_shou	Dismissed Genius	true
ceo_nodes_title_3k_main_ceo_career_historical_guan_chun	Soft Spoken Strategist	true
ceo_nodes_title_3k_main_ceo_career_historical_yang_chou	Karmic Killer	true
ceo_nodes_title_3k_main_ceo_career_historical_wang_baolan	Maiden of the Shadows	true
ceo_nodes_title_3k_main_ceo_career_historical_wang_fangyue	Seductive Whisperer	true
ceo_nodes_title_3k_main_ceo_career_historical_wang_lanlan	Short-tempered Princess	true
ceo_nodes_title_3k_main_ceo_career_historical_xianyu_yin	Courageous Cavalier	true
ceo_nodes_title_3k_main_ceo_career_historical_han_tong	Scion of Ye	true
ceo_nodes_title_3k_main_ceo_career_historical_xin_ping	Deceitful Trickster	true
ceo_nodes_title_3k_main_ceo_career_historical_sui_gu	Vengeful Brigand	true
ceo_nodes_title_3k_main_ceo_career_historical_cui_jun	Stalwart Son	true
ceo_nodes_title_3k_main_ceo_career_historical_deng_yuan	Dutiful Til The End	true
ceo_nodes_title_3k_main_ceo_career_historical_gao_lan	Hebei's Finest	true
ceo_nodes_title_3k_main_ceo_career_historical_gongsun_fan	Protector of Bohai	true
ceo_nodes_title_3k_main_ceo_career_historical_gongsun_gong	Neutered Castrate	true
ceo_nodes_title_3k_main_ceo_career_historical_gongsun_kang	Independent Trailblazer	true
ceo_nodes_title_3k_main_ceo_career_historical_gongsun_yue	Misfortunate Reinforcement	true
ceo_nodes_title_3k_main_ceo_career_historical_li_damu	Steely Gaze	true
ceo_nodes_title_3k_main_ceo_career_historical_liang_mao	Honourable Hostage	true
ceo_nodes_title_3k_main_ceo_career_historical_nanlou	The Howling Wolf	true
ceo_nodes_title_3k_main_ceo_career_historical_nie_tingping	Matriarch of Liaodong	true
ceo_nodes_title_3k_main_ceo_career_historical_qu_yi	Imperious Expert	true
ceo_nodes_title_3k_main_ceo_career_historical_tian_kai	Right Fist	true
ceo_nodes_title_3k_main_ceo_career_historical_yu_du	The Poisoned Fang	true
ceo_nodes_title_3k_main_ceo_career_historical_yuan_xi	Forgotten Son	true
ceo_nodes_title_3k_main_threshold_ceo_career_historical_qiulijiu	Leader of Five Thousand	true
ceo_nodes_title_3k_main_ceo_career_historical_yan_gang	Vanguard of White Horse Fellows	true
ceo_nodes_title_3k_main_ceo_career_historical_wang_dang	Snake in the Mountains	true
ceo_nodes_title_3k_main_ceo_career_historical_huanglong	The Dragon of Heishan	true
ceo_nodes_title_3k_main_ceo_career_historical_gongsun_yuan	The King of Yan	true
ceo_nodes_title_3k_main_ceo_career_historical_yan_rou	Frontier Peacekeeper	true
ceo_nodes_title_3k_main_ceo_career_historical_lady_zhang_shangxiu	Sapphire of Shangdang	true
ceo_nodes_title_3k_main_ceo_career_historical_lady_zhang_xiangyang	Maiden of the Blade	true
ceo_nodes_title_3k_main_ceo_node_career_historical_sheng_xian_01	The Brave Sheng	true
ceo_nodes_title_3k_main_ceo_career_historical_yang_biao	Eminent Excellency	true
ceo_nodes_title_3k_main_ceo_career_historical_lady_liu	Envious Matriarch	true
ceo_nodes_title_3k_main_ceo_career_historical_dong_li	Daughter of the Tyrant	true
ceo_nodes_title_3k_main_ceo_career_historical_fan_chou	The Voice of Reason	true
ceo_nodes_title_3k_main_ceo_career_historical_hu_zhen	Quarelled to the Grave	true
ceo_nodes_title_3k_main_ceo_career_historical_huche_er	Hulking Hitman	true
ceo_nodes_title_3k_main_ceo_career_historical_lady_yan	Blunt Confidant	true
ceo_nodes_title_3k_main_ceo_career_historical_li_li	Thuggish Protege	true
ceo_nodes_title_3k_main_ceo_career_historical_li_su	Of The Toxic Tongue	true
ceo_nodes_title_3k_main_ceo_career_historical_li_xian	Imperial Pursuer 	true
ceo_nodes_title_3k_main_ceo_career_historical_li_ying	Brazen Bully	true
ceo_nodes_title_3k_main_ceo_career_historical_niu_fu	Brutish Ringleader	true
ceo_nodes_title_3k_main_ceo_career_historical_qin_yilu	Shamed Cuckold	true
ceo_nodes_title_3k_main_ceo_career_historical_wang_feng	Treasonous Turncoat	true
ceo_nodes_title_3k_main_ceo_career_historical_xu_rong	The Consumate Professional	true
ceo_nodes_title_3k_main_ceo_career_historical_zhang_ji_dong	The Dashing Cavalier	true
ceo_nodes_title_3k_main_ceo_career_historical_cheng_yi	Bold Outrider	true
ceo_nodes_title_3k_main_ceo_career_historical_cheng_yin	Motivator of the Di	true
ceo_nodes_title_3k_main_ceo_career_historical_chenggong_ying	The Flight of Three Arrows	true
ceo_nodes_title_3k_main_ceo_career_historical_han_anyue	Rebellious Princess	true
ceo_nodes_title_3k_main_ceo_career_historical_han_chong	Snake in the Sand	true
ceo_nodes_title_3k_main_ceo_career_historical_han_xin	Envoy to the Qiang	true
ceo_nodes_title_3k_main_ceo_career_historical_hou_xuan	First in the Fray	true
ceo_nodes_title_3k_main_ceo_career_historical_li_kan	Huayin Highwayman	true
ceo_nodes_title_3k_main_ceo_career_historical_liang_xing	Bravo of Guanzhong	true
ceo_nodes_title_3k_main_ceo_career_historical_ma_wan	The Sentinel of Liang	true
ceo_nodes_title_3k_main_ceo_career_historical_miao_wanwan	Xiliang Tigeress	true
ceo_nodes_title_3k_main_ceo_career_historical_yang_qiu	Rider of Anding	true
ceo_nodes_title_3k_main_ceo_career_historical_zhang_heng	Vanguard of Weinan	true
ceo_nodes_title_3k_main_ceo_career_historical_yan_xing	Jincheng's Finest	true
ceo_nodes_title_3k_ironic_ceo_career_historical_bi_jieyan	Five Peck Priestess	true
ceo_nodes_title_3k_ironic_ceo_career_historical_fu_gan	Bridge to the West	true
ceo_nodes_title_3k_ironic_ceo_career_historical_lady_yang	Of The Trusting Smile	true
ceo_nodes_title_3k_ironic_ceo_career_historical_li_xiu	Of Sweet-Dew Sophistry	true
ceo_nodes_title_3k_ironic_ceo_career_historical_ma_tie	Of Trampling Hooves	true
ceo_nodes_title_3k_ironic_ceo_career_historical_ma_xiu	The Prideful Stallion	true
ceo_nodes_title_3k_ironic_ceo_career_historical_yan_pu	Devout Tactician	true
ceo_nodes_title_3k_ironic_ceo_career_historical_yang_ang	Bulwark of Yangping	true
ceo_nodes_title_3k_ironic_ceo_career_historical_yang_ren	Commander of the Passes	true
ceo_nodes_title_3k_ironic_ceo_career_historical_yang_song	Greedy and Conceited	true
ceo_nodes_title_3k_ironic_ceo_career_historical_zhang_fu	Zhengyi Zealot	true
ceo_nodes_title_3k_ironic_ceo_career_historical_zhang_guang	Ritualist of the Rice	true
ceo_nodes_title_3k_ironic_ceo_career_historical_zhang_wei	Guardian of Hanning	true
ceo_nodes_title_3k_dlc04_ceo_node_career_historical_ying_yang_delian_01	Master of Harmonies	true
ceo_nodes_title_3k_ironic_ceo_career_historical_yang_bo	Petty and Jealous	true
ceo_nodes_title_3k_ironic_ceo_career_historical_huang_quan	The Wise Realist	true
ceo_nodes_title_3k_ironic_ceo_career_historical_lady_liu_mengan	Dongzhou Dame	true
ceo_nodes_title_3k_ironic_ceo_career_historical_lady_liu_zhang	Tender and Delicate	true
ceo_nodes_title_3k_ironic_ceo_career_historical_lady_wu_xian	Empress Mu	true
ceo_nodes_title_3k_ironic_ceo_career_historical_lei_tong	Piercer of Defences	true
ceo_nodes_title_3k_ironic_ceo_career_historical_liu_mao	Sickly Scion	true
ceo_nodes_title_3k_ironic_ceo_career_historical_liu_xun	Filial Loyalist	true
ceo_nodes_title_3k_ironic_ceo_career_historical_pang_xi	Steadfast Confidant	true
ceo_nodes_title_3k_ironic_ceo_career_historical_peng_yang	Conceited Talent	true
ceo_nodes_title_3k_ironic_ceo_career_historical_wu_ban	Agile Assaulter	true
ceo_nodes_title_3k_ironic_ceo_career_historical_wu_kuang	Disciplined and Trustworthy	true
ceo_nodes_title_3k_ironic_ceo_career_historical_wu_yi	General who Attacks Rebels	true
ceo_nodes_title_3k_ironic_ceo_career_historical_zhang_ren	Staunch Guardian	true
ceo_nodes_title_3k_ironic_ceo_career_historical_zhu_gui	Bookish Biographer	true
ceo_nodes_title_3k_ironic_ceo_career_historical_yan_yan	The Seasoned Administrator	true
ceo_nodes_title_3k_ironic_ceo_career_historical_liu_fan	Household Commander	true
ceo_nodes_title_3k_ironic_ceo_career_historical_liu_dan	Conspiring Clerk	true
ceo_nodes_title_3k_ironic_ceo_career_historical_zhao_wei	Dongzhou Defier	true
ceo_nodes_title_3k_ironic_ceo_career_historical_chen_chao	Sichuan Loyalist	true
ceo_nodes_title_3k_ironic_ceo_career_historical_ren_qi	Ferocious Firestarter	true
ceo_nodes_title_3k_ironic_ceo_career_historical_yu_minxiang	Gem of Jianwei	true
ceo_nodes_title_3k_ironic_ceo_career_historical_wang_yun	Seven Star Statesman	true
ceo_nodes_title_3k_ironic_ceo_career_historical_dong_fu	Sincere Consultant	true
ceo_nodes_title_3k_main_ceo_career_historical_yuan_yao	The Mildmannered Son	false
ceo_nodes_title_3k_main_ceo_career_historical_yue_jiu	Aggressive Invader 	false
ceo_nodes_title_3k_main_ceo_career_historical_chen_ji	Shield of Shouchun	false
ceo_nodes_title_3k_main_ceo_career_historical_chen_lan	Thuggish Robber	false
ceo_nodes_title_3k_main_ceo_career_historical_lei_xu	Runan Renegade	false
ceo_nodes_title_3k_main_ceo_career_historical_mei_cheng	Contumelious Caitiff 	false
ceo_nodes_title_3k_main_ceo_career_historical_yang_hong	The Ignored Official	false
ceo_nodes_title_3k_main_ceo_career_historical_yuan_yin	Clan Caretaker	false
ceo_nodes_title_3k_main_ceo_career_historical_kuai_liang	The Seeker of Compromise	false
ceo_nodes_title_3k_main_ceo_career_historical_kuai_yue	Duplicitious Mastermind	false
ceo_nodes_title_3k_main_ceo_career_historical_lady_cai	Seductive Matriarch of the Cai	false
ceo_nodes_title_3k_main_ceo_career_historical_lou_gui	Mengmei Householder	false
ceo_nodes_title_3k_main_ceo_career_historical_wen_pin	The Infalliable Rampart	false
ceo_nodes_title_3k_main_ceo_career_historical_zhang_cheng	Virtuous Advisor	false
ceo_nodes_title_3k_main_ceo_career_historical_beolhyu	Regal and Warlike	false
ceo_nodes_title_3k_main_ceo_career_historical_chogo	Blitzing Besieger	false
ceo_nodes_title_3k_main_ceo_career_historical_gogukcheon	The Generous King	false
ceo_nodes_title_3k_main_ceo_career_historical_chen_jiu	Xiakou's Blade	false
ceo_nodes_title_3k_main_ceo_career_historical_huang_anbao	Of Serene Shores	false
ceo_nodes_title_3k_main_ceo_career_historical_huang_chengyan	Quiet Recluse	false
ceo_nodes_title_3k_main_ceo_career_historical_huang_she	The Tides of Defiance	false
ceo_nodes_title_3k_main_ceo_career_historical_huang_yueying	The Dragon's Aide	false
ceo_nodes_title_3k_main_ceo_career_historical_lady_huang_xie	Of The Defiant Waves	false
ceo_nodes_title_3k_main_ceo_career_historical_lu_gong	The Tiger's Bane	false
ceo_nodes_title_3k_main_ceo_career_historical_su_fei	The Coursing Corsair	false
ceo_nodes_title_3k_main_ceo_career_historical_zhang_hu	Naval Specialist	false
ceo_nodes_title_3k_main_ceo_career_historical_bao_xin	The Hero of Jinan	false
ceo_nodes_title_3k_main_ceo_career_historical_bao_xun	Defiant Critic	false
ceo_nodes_title_3k_main_ceo_career_historical_cai_he	Aspiring Agent	false
ceo_nodes_title_3k_main_ceo_career_historical_cai_xun	Disruptive Captain	false
ceo_nodes_title_3k_main_ceo_career_historical_cai_yan_m	Consistent Administrator	false
ceo_nodes_title_3k_main_ceo_career_historical_cai_zan	Middling Magistrate	false
ceo_nodes_title_3k_main_ceo_career_historical_cai_zhong	Of Dubious Deductions	false
ceo_nodes_title_3k_main_ceo_career_historical_cang_qinting	Of Delicate Touch	false
ceo_nodes_title_3k_main_ceo_career_historical_chang_xi	The Reed in the Winds	false
ceo_nodes_title_3k_main_ceo_career_historical_chen_deng	Man For All Seasons	false
ceo_nodes_title_3k_main_ceo_career_historical_chen_gui	Abundant Talent	false
ceo_nodes_title_3k_main_ceo_career_historical_chen_su	Living Legacy	false
ceo_nodes_title_3k_main_ceo_career_historical_chen_ying_z	Haughty Hurler	false
ceo_nodes_title_3k_main_ceo_career_historical_cheng_yu	Ruthless Pragmatist	false
ceo_nodes_title_3k_main_ceo_career_historical_cui_lie	Of Copper Scented Fingers	false
ceo_nodes_title_3k_main_ceo_career_historical_huang_wan	Model Minister	false
ceo_nodes_title_3k_main_ceo_career_historical_lady_gan	Wizened Madam	false
ceo_nodes_title_3k_main_ceo_career_historical_lady_liu_huimin	The Princess of Yan	false
ceo_nodes_title_3k_main_ceo_career_historical_lady_lu_yang	Household Manager	false
ceo_nodes_title_3k_main_ceo_career_historical_lady_ze_deng	Seeker of Riches	false
ceo_nodes_title_3k_main_ceo_career_historical_lady_zhang_zhumeng	Charming Hostess	false
ceo_nodes_title_3k_main_ceo_career_historical_liu_xun	Trusting Warlord	false
ceo_nodes_title_3k_main_ceo_career_historical_lu_ji	Filial Exemplar	false
ceo_nodes_title_3k_main_ceo_career_historical_lu_ju	Valiant and Distinguished	false
ceo_nodes_title_3k_main_ceo_career_historical_lu_jun	Gentleman Cadet	false
ceo_nodes_title_3k_main_ceo_career_historical_lu_kang	Paragon of Governance	false
ceo_nodes_title_3k_main_ceo_career_historical_lu_shang	Courageous Kinsman	false
ceo_nodes_title_3k_main_ceo_career_historical_mi_fang	Reliable Rearguard	false
ceo_nodes_title_3k_main_ceo_career_historical_shi_yi_w	Frugal and Unflappable	false
ceo_nodes_title_3k_main_ceo_career_historical_sun_guan	Babyfaced Bandit	false
ceo_nodes_title_3k_main_ceo_career_historical_sun_shao	Stoic Chancellor	false
ceo_nodes_title_3k_main_ceo_career_historical_tao_shang	Seeker of A Quiet Life	false
ceo_nodes_title_3k_main_ceo_career_historical_tao_ying	An Unassuming Son	false
ceo_nodes_title_3k_main_ceo_career_historical_tong_yurui	Genial and Acute	false
ceo_nodes_title_3k_main_ceo_career_historical_wang_hong	Middling Magistrate	false
ceo_nodes_title_3k_main_ceo_career_historical_wang_yu	Astute Consultant	false
ceo_nodes_title_3k_main_ceo_career_historical_xu_jing	Wandering Scholar	false
ceo_nodes_title_3k_main_ceo_career_historical_ying_shao	Compiler of Almanacs	false
ceo_nodes_title_3k_main_ceo_career_historical_zang_ba	Crafty Operator	false
ceo_nodes_title_3k_main_ceo_career_historical_zang_hong	Distinguished and Defiant	false
ceo_nodes_title_3k_main_ceo_career_historical_ze_bu	Seizer of Donations	false
ceo_nodes_title_3k_main_ceo_career_historical_ze_yue	Subtle Trickster	false
ceo_nodes_title_3k_main_ceo_career_historical_zhang_miao	Friend to All	false
ceo_nodes_title_3k_main_ceo_career_historical_zhang_yun	Resolute Admiral	false
ceo_nodes_title_3k_main_ceo_career_historical_zhao_fan	Canny Negotiatior	false
ceo_nodes_title_3k_main_ceo_career_historical_zheng_yan	Humble and Filial	false
ceo_nodes_title_3k_main_ceo_career_historical_zhou_ang	Militant Adminstrator	false
ceo_nodes_title_3k_main_ceo_career_historical_zhou_xin	The Lance of the South	false
ceo_nodes_title_3k_main_ceo_career_historical_zong_cheng	Upstanding Moralist	false
ceo_nodes_title_3k_main_ceo_career_historical_liu_qi	Fate's Ladder	false
ceo_nodes_title_3k_main_ceo_career_historical_liu_cong	Political Pawn	false
ceo_nodes_title_3k_main_ceo_career_historical_chen_wen	Rallier of Troops	false
ceo_nodes_title_3k_main_ceo_career_historical_zhu_hao	Unflappable Prefect	false
ceo_nodes_title_3k_main_ceo_career_historical_zhuge_xuan	The Nurturer of Dragons	false
ceo_nodes_title_3k_main_ceo_career_historical_zhang_xian	The Unquenchable Fire	false
ceo_nodes_title_3k_main_ceo_career_historical_zhang_jin	Obstinate Sorcerer	false
ceo_nodes_title_3k_main_ceo_career_historical_liu_pan	The Surging Skirmisher	false
ceo_nodes_title_3k_main_ceo_career_historical_wu_ju	Of Stormy Aggression	false
ceo_nodes_title_3k_main_ceo_career_historical_lai_gong	Humane Governor	false
ceo_nodes_title_3k_main_ceo_career_historical_Luo_Tong	The Humble Dawn	false
ceo_nodes_title_3k_main_ceo_career_historical_Xiahou_Ba	Intrepid Scout	false
ceo_nodes_title_3k_main_ceo_career_historical_Mi_Heng	Truths Laid Bare	false
ceo_nodes_title_3k_main_ceo_career_historical_Li_Yan	Logistical Orchestrator	false
ceo_nodes_title_3k_main_ceo_career_historical_Sima_Shi	Of The All-Seeing Eye	false
ceo_nodes_title_3k_main_ceo_career_historical_Sima_Zhao	Usurping Mastermind	false
ceo_nodes_title_3k_main_ceo_career_historical_Wang_Yi	Woman Scorned	false
ceo_nodes_title_3k_main_ceo_career_historical_Pan_Feng	The Greatest of All Time	false
ceo_nodes_title_3k_main_ceo_career_historical_Kuitou	The Regent Chief	false
ceo_nodes_title_3k_main_ceo_career_historical_Kebineng	The Indomitable Flame	false
ceo_nodes_title_3k_main_ceo_career_historical_QIianman	The Xianbei Prince	false
ceo_nodes_title_3k_main_ceo_career_historical_Budugen	Fierce Raider	false
ceo_nodes_title_3k_main_ceo_career_historical_Fulohan	Furious Bladesman	false
ceo_nodes_title_3k_main_ceo_career_historical_Suli	Xianbei Tradesman	false
ceo_nodes_title_3k_main_ceo_career_historical_Chenglugui	Tribal Diplomat	false
ceo_nodes_title_3k_main_ceo_career_historical_Mohuba	Born In The Saddle	false
ceo_nodes_title_3k_main_ceo_career_historical_tuoba_jiefan	The Farseeing Hunter	false
ceo_nodes_title_3k_main_ceo_career_historical_tuoba_liwei	Auspicious Patriarch	false
ceo_nodes_title_3k_main_ceo_career_historical_tufa_pigu	The Rampaging Boar	false
ceo_nodes_title_3k_main_ceo_career_historical_Guo_Huai	Perceptive General	false
ceo_nodes_title_3k_main_ceo_career_historical_Zhong_Yao	Esoteric Wordsmith	false
ceo_nodes_title_3k_main_ceo_career_historical_Zhong_Hui	Of Flamboyant Ambition	false
ceo_nodes_title_3k_main_ceo_career_historical_Wang_Yuanji	Of Headstrong Expertise	false
ceo_nodes_title_3k_main_ceo_career_historical_Zhang_Chunhua	Ingenious and Calculating	false
ceo_nodes_title_3k_main_ceo_career_historical_Bao_Sanniang	The Courageous Beauty	false
ceo_nodes_title_3k_main_ceo_career_historical_Guan_Xing	The Rising Star	false
ceo_nodes_title_3k_main_ceo_career_historical_Guan_Suo	The Handsome Flower	false
ceo_nodes_title_3k_main_ceo_career_historical_Man_Chong	 Uncompromising Arbiter	false
ceo_nodes_title_3k_main_ceo_career_historical_Jia_Chong	The Lurker in the Shadows	false
ceo_nodes_title_3k_main_ceo_career_historical_Jia_Kui	Tactical Minded Minister	false
ceo_nodes_title_3k_main_ceo_career_historical_Li_Dian	Of Steady Caution	false
ceo_nodes_title_3k_main_ceo_career_historical_Liu_Feng	Of Rapid Reinforcement	false
ceo_nodes_title_3k_main_ceo_career_historical_Guan_Ping	Staunch Retainer	false
ceo_nodes_title_3k_main_ceo_career_historical_Jiang_Wei	Budding Commander	false
ceo_nodes_title_3k_main_ceo_career_historical_Liu_Shan	Gentle Complacency	false
ceo_nodes_title_3k_main_ceo_career_historical_Deng_Ai	Meticulous Orienteer	false
ceo_nodes_title_3k_main_ceo_career_historical_Xin_Xianying	The Virtuous Adviser	false
ceo_nodes_title_3k_main_ceo_career_historical_Chen_Dao	White Feathered General	false
ceo_nodes_title_3k_main_ceo_career_historical_Song_Xian	Headstrong Brawler	false
ceo_nodes_title_3k_main_ceo_career_historical_Wei_Xu	Defender of Camps	false
ceo_nodes_title_3k_main_ceo_career_historical_Hou_Cheng	Of Deft Swiftness	false
ceo_nodes_title_3k_main_ceo_career_historical_Cao_Xing	Gouging Sniper	false
ceo_nodes_title_3k_main_ceo_career_historical_guo_nuwang	Striking Majesty	false
ceo_nodes_title_3k_main_ceo_career_historical_guo_tu	Erratic Advisor	false
ceo_nodes_title_3k_main_ceo_career_historical_mike	Dynamic Mike	false
ceo_nodes_title_3k_main_ceo_career_historical_pang_ji`	Vindictive Sneak	false
ceo_nodes_title_3k_main_ceo_career_historical_tian_yu	Gallant Leopard	false
ceo_nodes_title_3k_main_ceo_career_historical_xun_chen	Wily Instigator	false
ceo_nodes_title_3k_main_ceo_career_historical_zao_zhi	Father of the Tuntian	false
ceo_nodes_title_3k_main_ceo_career_historical_jueji	Gregarious Bowman	false
ceo_nodes_title_3k_main_ceo_career_historical_agui	Unshakable Headsman	false
ceo_nodes_title_3k_main_ceo_career_historical_dou_mao	The Master of the Valleys	false
ceo_nodes_title_3k_main_ceo_career_historical_lady_yang_di	The Prowling Tigress	false
ceo_nodes_title_3k_main_ceo_career_historical_yang_qianwan	The Vertiginous Quake	false
ceo_nodes_title_3k_main_ceo_career_historical_qiang_duan	Of Lofty Peaks	false
ceo_nodes_title_3k_main_ceo_career_historical_gan_ji	Ill-mannered Mystic	false
ceo_nodes_title_3k_main_ceo_career_historical_zuo_ci	Arcane Meddler	false
ceo_nodes_title_3k_main_ceo_career_historical_hua_tuo	Medicinal Master	false
ceo_nodes_title_3k_main_ceo_career_historical_handan_shang	The Steadyhanded Prefect	false
ceo_nodes_title_3k_main_ceo_career_historical_huang_ang	Guts and Guile	false
ceo_nodes_title_3k_main_ceo_career_historical_huang_hua	The Brash Ox	false
ceo_nodes_title_3k_main_ceo_career_historical_ma_ai	The Corridor's Warden	false
ceo_nodes_title_3k_main_ceo_career_historical_pang_yu	Righteous Avenger	false
ceo_nodes_title_3k_main_ceo_career_historical_su_ze	The Pearl of the West	false
ceo_nodes_title_3k_main_ceo_career_historical_wei_dan	Cursive Saint	false
ceo_nodes_title_3k_main_ceo_career_historical_wei_kang	Resilient Inspector	false
ceo_nodes_title_3k_main_ceo_career_historical_yang_feng_nw	Valliant Youxia 	false
ceo_nodes_title_3k_main_ceo_career_historical_yang_fu	Sardonic Strategist	false
ceo_nodes_title_3k_main_ceo_career_historical_zhang_gong	The Forthcoming Arbiter	false
ceo_nodes_title_3k_main_ceo_career_historical_zhang_meng	Unworthy Scion of Wuwei	false
ceo_nodes_title_3k_main_ceo_career_historical_zhao_ang	Ill-fortuned Patriarch	false
ceo_nodes_title_3k_main_ceo_career_historical_zhao_e	The Dauntless Swordswoman	false
ceo_nodes_title_3k_main_ceo_career_historical_zhang_jin_nw	Audacious Renegade	false
ceo_nodes_title_3k_main_ceo_career_historical_congqian	For A Fistful of Copper	false
ceo_nodes_title_3k_main_ceo_career_historical_guo_da	Ardent Pillager 	false
ceo_nodes_title_3k_main_ceo_career_historical_hu_mao	Heedful Prefect	false
ceo_nodes_title_3k_main_ceo_career_historical_liao_hua_ytr	Of Enduring Duty	false
ceo_nodes_title_3k_main_ceo_career_historical_shi_huang_sg	Southern Gentlemen	false
ceo_nodes_title_3k_main_ceo_career_historical_sima_ju_ytr	Zealous and Incessant	false
ceo_nodes_title_3k_main_ceo_career_historical_xu_he_ytr	Of Optmistic Persistence	false
ceo_nodes_title_3k_main_ceo_career_historical_yin_li	The Creeping Shadow	false
ceo_nodes_title_3k_main_ceo_career_historical_zhao_bo_ytr	Breaker of Gates	false
ceo_nodes_title_3k_main_ceo_career_historical_xin_pi	Outspoken and Upright	false
ceo_nodes_title_3k_main_ceo_career_historical_lady_xiahou	Victim of Spoils	false
ceo_nodes_title_3k_main_ceo_career_historical_cao_anmin	Valiant Kinsman	false
ceo_nodes_title_3k_main_ceo_career_historical_quan_rou	Hale and Hearty	false
ceo_nodes_title_3k_main_ceo_career_historical_zhang_nan	The Last Line	false
ceo_nodes_title_3k_main_ceo_career_historical_xiahou_jie	Bravely Bold Sir Xiahou	false
ceo_nodes_title_3k_main_ceo_career_historical_zhou_yu_renming	Militant Prefect	false
ceo_nodes_title_3k_main_ceo_career_historical_bian_rang	Caustic Critic	false
ceo_nodes_title_3k_main_ceo_career_historical_chen_yu	The Fifth Column	false
ceo_nodes_title_3k_main_ceo_career_historical_xi_zhicai	Irreplaceable Adjutant 	false
ceo_nodes_title_3k_main_ceo_career_historical_dong_zhao	Perfectly Cromulent	false
ceo_nodes_title_3k_main_ceo_career_historical_ma_midi	Counsellor Remonstrant	false
ceo_nodes_title_3k_main_ceo_career_historical_huo_nu	The Terror of the Umbral	false
ceo_nodes_title_3k_main_ceo_career_historical_gao_rou	Incorruptible and Veracious	false
ceo_nodes_title_3k_main_ceo_career_historical_liu_ye	Methodical Technician	false
ceo_nodes_title_3k_main_ceo_career_historical_syiyan	Peerless Huntress	false
ceo_nodes_title_3k_main_ceo_career_historical_yalu	The Frigid Tempest	false
ceo_nodes_title_3k_main_ceo_career_historical_feng_fang	Bitter Adversary	false
ceo_nodes_title_3k_main_ceo_career_historical_li_tong	The Heroic Sellsword	false
ceo_nodes_title_3k_main_ceo_career_historical_huo_jun	Astute Militiaman 	false
ceo_nodes_title_3k_main_ceo_career_historical_ji_ben	Dutiful Physician	false
ceo_nodes_title_3k_main_ceo_career_historical_wei_huang	Spear of Justice	false
ceo_nodes_title_3k_main_ceo_career_historical_zhu_jun	Grizzled and Defiant	false
ceo_nodes_title_3k_main_ceo_career_historical_zuozi_zhangba	Of The Fifty-Foot Moustache 	false
ceo_nodes_title_3k_main_ceo_career_historical_hao_meng	Treacherous Rogue	false
ceo_nodes_title_3k_main_ceo_career_historical_jue_jiejie	Humble Aristocrat	false
ceo_nodes_title_3k_main_ceo_career_historical_xue_li	Diligent Watchman	false
ceo_nodes_title_3k_main_ceo_career_historical_chen_heng	Of Reckless Aplomb	false
ceo_nodes_title_3k_main_ceo_career_historical_liu_shang	Magnanimous Inspector	false
ceo_nodes_title_3k_main_ceo_career_historical_liu_pingming	Regal and Shining	false
ceo_nodes_title_3k_main_ceo_career_historical_liu_ji	Handsome Courtier	false
ceo_nodes_title_3k_main_ceo_career_historical_liu_shuo	Striking and Princely	false
ceo_nodes_title_3k_main_ceo_career_historical_zhang_ying	Niuzhu Protector	false
ceo_nodes_title_3k_main_ceo_career_historical_qin_song	Cunning Consultant	false
ceo_nodes_title_3k_main_ceo_career_historical_yu_mi	Headfirst Into the Fray	false
ceo_nodes_title_3k_main_ceo_career_historical_teng_dan	Able Clerk	false
ceo_nodes_title_3k_main_ceo_career_historical_teng_zhou	Erudite Prefect	false
ceo_nodes_title_3k_main_ceo_career_historical_chen_duan	Capable Advisor	false
ceo_nodes_title_3k_main_ceo_career_historical_sun_yi	Dashing Swordsman	false
ceo_nodes_title_3k_main_ceo_career_historical_sun_kuang	Diplomatic Advocate	false
ceo_nodes_title_3k_main_ceo_career_historical_sun_lang	Torchbearing Pyrophile	false
ceo_nodes_title_3k_main_ceo_career_historical_sun_jing	Composed and Genteel	false
ceo_nodes_title_3k_main_ceo_career_historical_sun_ben	The Indomitable Lance	false
ceo_nodes_title_3k_main_ceo_career_historical_sun_fu	Acute Besieger	false
ceo_nodes_title_3k_main_ceo_career_historical_sun_hao	Ardent Schemer	false
ceo_nodes_title_3k_main_ceo_career_historical_sun_yu	Resourceful Governor	false
ceo_nodes_title_3k_main_ceo_career_historical_sun_jiao	The Sharpened Blade	false
ceo_nodes_title_3k_main_ceo_career_historical_sun_he	Faithful Retainer	false
ceo_nodes_title_3k_main_ceo_career_historical_sun_shao_sun	Of Frosty Winds	false
ceo_nodes_title_3k_main_ceo_career_historical_zu_mao	The Scarlet Sacrifice	false
ceo_nodes_title_3k_main_ceo_career_historical_zhu_ran	The Scorching Heart	false
ceo_nodes_title_3k_main_ceo_career_historical_zhu_zhi	Distinguished Administrator	false
ceo_nodes_title_3k_main_ceo_career_historical_han_dang	Loyal Mercenary	false
ceo_nodes_title_3k_main_ceo_career_historical_fan_neng	Adept Fighter	false
ceo_nodes_title_3k_main_ceo_career_historical_mao_jie	Enforcer of Morals	false
ceo_nodes_title_3k_main_ceo_career_historical_liu_min	The Gentle Dreamer	false
ceo_nodes_title_3k_main_ceo_career_historical_zhou_cang	Of The Tireless Blitz	false
ceo_nodes_title_3k_main_ceo_career_historical_wang_ping	Of Extraordinary Capability	false
ceo_nodes_title_3k_main_ceo_career_historical_ruan_ji	Sagacious Wonder	false
ceo_nodes_title_3k_main_ceo_career_historical_shi_huan	Eagle Eyed Supervisor	false
ceo_nodes_title_3k_main_ceo_career_historical_cai_yang	Aggressive Commander	false
ceo_nodes_title_3k_main_ceo_career_historical_yang_xiu	For Want of a Chicken Rib	false
ceo_nodes_title_3k_main_ceo_career_historical_liu_yan_drunk	Extravagant Alcoholic	false
ceo_nodes_title_3k_main_ceo_career_historical_xiahou_shang	Gentleman of all Purposes	false
ceo_nodes_title_3k_main_ceo_career_historical_meng_da	Unscrupulous Troublemaker	false
ceo_nodes_title_3k_main_ceo_career_historical_hou_yin	Downtrodden Revolutionary	false
ceo_nodes_title_3k_main_ceo_career_historical_chen_zhen	Honest and Forthcoming	false
ceo_nodes_title_3k_main_ceo_career_historical_sun_deng	Charming Prince	false
ceo_nodes_title_3k_main_ceo_career_historical_bu_lianshi	Modest Beauty	false
