key	text	tooltip
#Loc;1;text/db/factions/faction_resources/chenwenresource/chen_wen_effect_bundles.loc		
effect_bundles_localised_title_ironic_coalition_of_the_plains_captives_execute	PLACEHOLDER	false
effect_bundles_localised_description_ironic_coalition_of_the_plains_captives_execute	PLACEHOLDER	false
effect_bundles_localised_title_ironic_coalition_of_the_plains_captives_recruit	PLACEHOLDER	false
effect_bundles_localised_description_ironic_coalition_of_the_plains_captives_recruit	PLACEHOLDER	false
effect_bundles_localised_title_ironic_coalition_of_the_plains_captives_release	PLACEHOLDER	false
effect_bundles_localised_description_ironic_coalition_of_the_plains_captives_release	PLACEHOLDER	false
effect_bundles_localised_title_ironic_coalition_of_the_plains_garrisoned	PLACEHOLDER	false
effect_bundles_localised_description_ironic_coalition_of_the_plains_garrisoned	PLACEHOLDER	false
effect_bundles_localised_title_ironic_coalition_of_the_plains_vassalized	PLACEHOLDER	false
effect_bundles_localised_description_ironic_coalition_of_the_plains_vassalized	PLACEHOLDER	false
effect_bundles_localised_title_ironic_coalition_of_the_plains_effect_bundle	Web of Diplomacy	false
effect_bundles_localised_description_ironic_coalition_of_the_plains_effect_bundle	With mastery of politics and careful negotiation, Chen Wen spreads his influence in every direction.	false
effect_bundles_localised_title_3k_dlc04_faction_bian_zhang_chen_wen_effect	Allied with Bian Zhang's faction	false
effect_bundles_localised_description_3k_dlc04_faction_bian_zhang_chen_wen_effect	You are allied with this faction.	false
effect_bundles_localised_title_3k_dlc04_faction_cao_song_chen_wen_effect	Allied with Cao Song's Faction	false
effect_bundles_localised_description_3k_dlc04_faction_cao_song_chen_wen_effect	You are allied with this faction.	false
effect_bundles_localised_title_3k_dlc04_faction_chen_gui_chen_wen_effect	Allied with Chen Gui's Faction	false
effect_bundles_localised_description_3k_dlc04_faction_chen_gui_chen_wen_effect	You are allied with this faction.	false
effect_bundles_localised_title_3k_dlc04_faction_chu_gong_chen_wen_effect	Allied with Chu Gong's Faction	false
effect_bundles_localised_description_3k_dlc04_faction_chu_gong_chen_wen_effect	You are allied with this faction.	false
effect_bundles_localised_title_3k_dlc04_faction_dai_chen_wen_effect	Allied with Dai's Faction	false
effect_bundles_localised_description_3k_dlc04_faction_dai_chen_wen_effect	You are allied with this faction.	false
effect_bundles_localised_title_3k_dlc04_faction_ding_yuan_chen_wen_effect	Allied with Ding Yuan's Faction	false
effect_bundles_localised_description_3k_dlc04_faction_ding_yuan_chen_wen_effect	You are allied with this faction.	false
effect_bundles_localised_title_3k_dlc04_faction_dong_chen_wen_effect	Allied with Dong's Faction	false
effect_bundles_localised_description_3k_dlc04_faction_dong_chen_wen_effect	You are allied with this faction.	false
effect_bundles_localised_title_3k_dlc04_faction_dong_he_chen_wen_effect	Allied with Dong He's Faction	false
effect_bundles_localised_description_3k_dlc04_faction_dong_he_chen_wen_effect	You are allied with this faction.	false
effect_bundles_localised_title_3k_dlc04_faction_empress_he_chen_wen_effect	Allied with Empress He's Faction	false
effect_bundles_localised_description_3k_dlc04_faction_empress_he_chen_wen_effect	You are allied with this faction.	false
effect_bundles_localised_title_3k_dlc04_faction_liang_rebels_chen_wen_effect	Allied with Liang Rebels' Faction	false
effect_bundles_localised_description_3k_dlc04_faction_liang_rebels_chen_wen_effect	You are allied with this faction.	false
effect_bundles_localised_title_3k_dlc04_faction_liu_hong_chen_wen_effect	Allied with Liu Hong's Faction	false
effect_bundles_localised_description_3k_dlc04_faction_liu_hong_chen_wen_effect	You are allied with this faction.	false
effect_bundles_localised_title_3k_dlc04_faction_liu_xun_chen_wen_effect	Allied with Liu Xun's Faction	false
effect_bundles_localised_description_3k_dlc04_faction_liu_xun_chen_wen_effect	You are allied with this faction.	false
effect_bundles_localised_title_3k_dlc04_faction_lu_kang_chen_wen_effect	Allied with Lu Kang's Faction	false
effect_bundles_localised_description_3k_dlc04_faction_lu_kang_chen_wen_effect	You are allied with this faction.	false
effect_bundles_localised_title_3k_dlc04_faction_lu_zhi_chen_wen_effect	Allied with Lu Zhi's Faction	false
effect_bundles_localised_description_3k_dlc04_faction_lu_zhi_chen_wen_effect	You are allied with this faction.	false
effect_bundles_localised_title_3k_dlc04_faction_prince_liu_chong_chen_wen_effect	Allied with Prince Liu Chong's Faction	false
effect_bundles_localised_description_3k_dlc04_faction_prince_liu_chong_chen_wen_effect	You are allied with this faction.	false
effect_bundles_localised_title_3k_dlc04_faction_qiao_mao_chen_wen_effect	Allied with Qiao Mao's Faction	false
effect_bundles_localised_description_3k_dlc04_faction_qiao_mao_chen_wen_effect	You are allied with this faction.	false
effect_bundles_localised_title_3k_dlc04_faction_rebels_chen_wen_effect	Allied with Rebels' Faction	false
effect_bundles_localised_description_3k_dlc04_faction_rebels_chen_wen_effect	You are allied with this faction.	false
effect_bundles_localised_title_3k_dlc04_faction_wang_rui_chen_wen_effect	Allied with Wang Rui's Faction	false
effect_bundles_localised_description_3k_dlc04_faction_wang_rui_chen_wen_effect	You are allied with this faction.	false
effect_bundles_localised_title_3k_dlc04_faction_wei_chen_wen_effect	Allied with Wei's Faction	false
effect_bundles_localised_description_3k_dlc04_faction_wei_chen_wen_effect	You are allied with this faction.	false
effect_bundles_localised_title_3k_dlc04_faction_xin_xuan_chen_wen_effect	Allied with Xin Xuan's Faction	false
effect_bundles_localised_description_3k_dlc04_faction_xin_xuan_chen_wen_effect	You are allied with this faction.	false
effect_bundles_localised_title_3k_dlc04_faction_ying_shao_chen_wen_effect	Allied with Ying Shao's Faction	false
effect_bundles_localised_description_3k_dlc04_faction_ying_shao_chen_wen_effect	You are allied with this faction.	false
effect_bundles_localised_title_3k_dlc04_faction_yizhou_island_chen_wen_effect	Allied with Yizhou Island's Faction	false
effect_bundles_localised_description_3k_dlc04_faction_yizhou_island_chen_wen_effect	You are allied with this faction.	false
effect_bundles_localised_title_3k_dlc04_faction_yuan_yi_chen_wen_effect	Allied with Yuan Yi's Faction	false
effect_bundles_localised_description_3k_dlc04_faction_yuan_yi_chen_wen_effect	You are allied with this faction.	false
effect_bundles_localised_title_3k_dlc04_faction_zhang_bao_chen_wen_effect	Allied with Zhang Bao's Faction	false
effect_bundles_localised_description_3k_dlc04_faction_zhang_bao_chen_wen_effect	You are allied with this faction.	false
effect_bundles_localised_title_3k_dlc04_faction_zhang_jue_chen_wen_effect	Allied with Zhang Jue's Faction	false
effect_bundles_localised_description_3k_dlc04_faction_zhang_jue_chen_wen_effect	You are allied with this faction.	false
effect_bundles_localised_title_3k_dlc04_faction_zhang_liang_chen_wen_effect	Allied with Zhang Liang's Faction	false
effect_bundles_localised_description_3k_dlc04_faction_zhang_liang_chen_wen_effect	You are allied with this faction.	false
effect_bundles_localised_title_3k_dlc04_faction_zhou_xin_chen_wen_effect	Allied with Zhou Xin's Faction	false
effect_bundles_localised_description_3k_dlc04_faction_zhou_xin_chen_wen_effect	You are allied with this faction.	false
effect_bundles_localised_title_3k_dlc05_faction_hua_xin_chen_wen_effect	Allied with Hua Xin's Faction	false
effect_bundles_localised_description_3k_dlc05_faction_hua_xin_chen_wen_effect	You are allied with this faction.	false
effect_bundles_localised_title_3k_dlc05_faction_sheng_xian_chen_wen_effect	Allied with Sheng Xian's Faction	false
effect_bundles_localised_description_3k_dlc05_faction_sheng_xian_chen_wen_effect	You are allied with this faction.	false
effect_bundles_localised_title_3k_dlc05_faction_shi_huang_chen_wen_effect	Allied with Shi Huang's Faction	false
effect_bundles_localised_description_3k_dlc05_faction_shi_huang_chen_wen_effect	You are allied with this faction.	false
effect_bundles_localised_title_3k_dlc05_faction_shi_wu_chen_wen_effect	Allied with Shi Wu's Faction	false
effect_bundles_localised_description_3k_dlc05_faction_shi_wu_chen_wen_effect	You are allied with this faction.	false
effect_bundles_localised_title_3k_dlc05_faction_shi_yi_chen_wen_effect	Allied with Shi Yi's Faction	false
effect_bundles_localised_description_3k_dlc05_faction_shi_yi_chen_wen_effect	You are allied with this faction.	false
effect_bundles_localised_title_3k_dlc05_faction_sun_ce_chen_wen_effect	Allied with Sun Ce's Faction	false
effect_bundles_localised_description_3k_dlc05_faction_sun_ce_chen_wen_effect	You are allied with this faction.	false
effect_bundles_localised_title_3k_dlc05_faction_tian_kai_chen_wen_effect	Allied with Tian Kai's Faction	false
effect_bundles_localised_description_3k_dlc05_faction_tian_kai_chen_wen_effect	You are allied with this faction.	false
effect_bundles_localised_title_3k_dlc05_faction_white_tiger_yan_chen_wen_effect	Allied with White Tiger Yan's Faction	false
effect_bundles_localised_description_3k_dlc05_faction_white_tiger_yan_chen_wen_effect	You are allied with this faction.	false
effect_bundles_localised_title_3k_dlc05_faction_wu_jing_chen_wen_effect	Allied with Wu Jing's Faction	false
effect_bundles_localised_description_3k_dlc05_faction_wu_jing_chen_wen_effect	You are allied with this faction.	false
effect_bundles_localised_title_3k_dlc05_faction_xu_gong_chen_wen_effect	Allied with Xu Gong's Faction	false
effect_bundles_localised_description_3k_dlc05_faction_xu_gong_chen_wen_effect	You are allied with this faction.	false
effect_bundles_localised_title_3k_dlc05_faction_xu_zhao_chen_wen_effect	Allied with Xu Zhao's Faction	false
effect_bundles_localised_description_3k_dlc05_faction_xu_zhao_chen_wen_effect	You are allied with this faction.	false
effect_bundles_localised_title_3k_dlc05_faction_xue_li_chen_wen_effect	Allied with Xue Li's Faction	false
effect_bundles_localised_description_3k_dlc05_faction_xue_li_chen_wen_effect	You are allied with this faction.	false
effect_bundles_localised_title_3k_dlc05_faction_yang_feng_chen_wen_effect	Allied with Yang Feng's Faction	false
effect_bundles_localised_description_3k_dlc05_faction_yang_feng_chen_wen_effect	You are allied with this faction.	false
effect_bundles_localised_title_3k_dlc05_faction_yuan_tan_chen_wen_effect	Allied with Yuan Tan's Faction	false
effect_bundles_localised_description_3k_dlc05_faction_yuan_tan_chen_wen_effect	You are allied with this faction.	false
effect_bundles_localised_title_3k_dlc05_faction_zang_ba_chen_wen_effect	Allied with Zang Ba's Faction	false
effect_bundles_localised_description_3k_dlc05_faction_zang_ba_chen_wen_effect	You are allied with this faction.	false
effect_bundles_localised_title_3k_dlc05_faction_zhu_fu_chen_wen_effect	Allied with Zhu Fu's Faction	false
effect_bundles_localised_description_3k_dlc05_faction_zhu_fu_chen_wen_effect	You are allied with this faction.	false
effect_bundles_localised_title_3k_dlc06_faction_jiuzhen_chen_wen_effect	Allied with Jiuzhen's Faction	false
effect_bundles_localised_description_3k_dlc06_faction_jiuzhen_chen_wen_effect	You are allied with this faction.	false
effect_bundles_localised_title_3k_dlc06_faction_liaodong_chen_wen_effect	Allied with Liaodong's Faction	false
effect_bundles_localised_description_3k_dlc06_faction_liaodong_chen_wen_effect	You are allied with this faction.	false
effect_bundles_localised_title_3k_dlc06_faction_nanman_ahuinan_chen_wen_effect	Allied with Nanman Aihuinan's Faction	false
effect_bundles_localised_description_3k_dlc06_faction_nanman_ahuinan_chen_wen_effect	You are allied with this faction.	false
effect_bundles_localised_title_3k_dlc06_faction_nanman_dongtuna_chen_wen_effect	Allied with Nanman Dongtuna's Faction	false
effect_bundles_localised_description_3k_dlc06_faction_nanman_dongtuna_chen_wen_effect	You are allied with this faction.	false
effect_bundles_localised_title_3k_dlc06_faction_nanman_jiangyang_chen_wen_effect	Allied with Nanman Jiangyang's Faction	false
effect_bundles_localised_description_3k_dlc06_faction_nanman_jiangyang_chen_wen_effect	You are allied with this faction.	false
effect_bundles_localised_title_3k_dlc06_faction_nanman_jianning_chen_wen_effect	Allied with Nanman Jianning's Faction	false
effect_bundles_localised_description_3k_dlc06_faction_nanman_jianning_chen_wen_effect	You are allied with this faction.	false
effect_bundles_localised_title_3k_dlc06_faction_nanman_jiaozhi_chen_wen_effect	Allied with Nanman Jiaozhi's Faction	false
effect_bundles_localised_description_3k_dlc06_faction_nanman_jiaozhi_chen_wen_effect	You are allied with this faction.	false
effect_bundles_localised_title_3k_dlc06_faction_nanman_jinhuansanjie_chen_wen_effect	Allied with Nanman Jinhuansanjie's Faction	false
effect_bundles_localised_description_3k_dlc06_faction_nanman_jinhuansanjie_chen_wen_effect	You are allied with this faction.	false
effect_bundles_localised_title_3k_dlc06_faction_nanman_king_duosi_chen_wen_effect	Allied with Nanman King Duosi's Faction	false
effect_bundles_localised_description_3k_dlc06_faction_nanman_king_duosi_chen_wen_effect	You are allied with this faction.	false
effect_bundles_localised_title_3k_dlc06_faction_nanman_king_meng_huo_chen_wen_effect	Allied with Nanman King Meng Huo's Faction	false
effect_bundles_localised_description_3k_dlc06_faction_nanman_king_meng_huo_chen_wen_effect	You are allied with this faction.	false
effect_bundles_localised_title_3k_dlc06_faction_nanman_king_mulu_chen_wen_effect	Allied with Nanman King Mulu's Faction	false
effect_bundles_localised_description_3k_dlc06_faction_nanman_king_mulu_chen_wen_effect	You are allied with this faction.	false
effect_bundles_localised_title_3k_dlc06_faction_nanman_king_shamoke_chen_wen_effect	Allied with Nanman King Shamoke's Faction	false
effect_bundles_localised_description_3k_dlc06_faction_nanman_king_shamoke_chen_wen_effect	You are allied with this faction.	false
effect_bundles_localised_title_3k_dlc06_faction_nanman_king_wutugu_chen_wen_effect	Allied with Nanman King Wutugu's Faction	false
effect_bundles_localised_description_3k_dlc06_faction_nanman_king_wutugu_chen_wen_effect	You are allied with this faction.	false
effect_bundles_localised_title_3k_dlc06_faction_nanman_lady_zhurong_chen_wen_effect	Allied with Nanman Lady Zhurong's Faction	false
effect_bundles_localised_description_3k_dlc06_faction_nanman_lady_zhurong_chen_wen_effect	You are allied with this faction.	false
effect_bundles_localised_title_3k_dlc06_faction_nanman_mangyachang_chen_wen_effect	Allied with Nanman Mangyachang's Faction	false
effect_bundles_localised_description_3k_dlc06_faction_nanman_mangyachang_chen_wen_effect	You are allied with this faction.	false
effect_bundles_localised_title_3k_dlc06_faction_nanman_rebels_chen_wen_effect	Allied with Nanman Rebels' Faction	false
effect_bundles_localised_description_3k_dlc06_faction_nanman_rebels_chen_wen_effect	You are allied with this faction.	false
effect_bundles_localised_title_3k_dlc06_faction_nanman_tu_an_chen_wen_effect	Allied with Nanman Tu An's Faction	false
effect_bundles_localised_description_3k_dlc06_faction_nanman_tu_an_chen_wen_effect	You are allied with this faction.	false
effect_bundles_localised_title_3k_dlc06_faction_nanman_xi_ni_chen_wen_effect	Allied with Nanman Xi Ni's Faction	false
effect_bundles_localised_description_3k_dlc06_faction_nanman_xi_ni_chen_wen_effect	You are allied with this faction.	false
effect_bundles_localised_title_3k_dlc06_faction_nanman_yang_feng_chen_wen_effect	Allied with Nanman Yang Feng's Faction	false
effect_bundles_localised_description_3k_dlc06_faction_nanman_yang_feng_chen_wen_effect	You are allied with this faction.	false
effect_bundles_localised_title_3k_dlc06_faction_nanman_yongchang_chen_wen_effect	Allied with Nanman Yongchang's Faction	false
effect_bundles_localised_description_3k_dlc06_faction_nanman_yongchang_chen_wen_effect	You are allied with this faction.	false
effect_bundles_localised_title_3k_dlc06_faction_nanman_yunnan_chen_wen_effect	Allied with Nanman Yunnan's Faction	false
effect_bundles_localised_description_3k_dlc06_faction_nanman_yunnan_chen_wen_effect	You are allied with this faction.	false
effect_bundles_localised_title_3k_dlc06_faction_nanman_zangke_chen_wen_effect	Allied with Nanman Zangke's Faction	false
effect_bundles_localised_description_3k_dlc06_faction_nanman_zangke_chen_wen_effect	You are allied with this faction.	false
effect_bundles_localised_title_3k_dlc06_faction_xiapi_chen_wen_effect	Allied with Xiapi's Faction	false
effect_bundles_localised_description_3k_dlc06_faction_xiapi_chen_wen_effect	You are allied with this faction.	false
effect_bundles_localised_title_3k_dlc06_faction_yongchang_chen_wen_effect	Allied with Yongchang's Faction	false
effect_bundles_localised_description_3k_dlc06_faction_yongchang_chen_wen_effect	You are allied with this faction.	false
effect_bundles_localised_title_3k_dlc06_faction_yunnan_chen_wen_effect	Allied with Yunnan's Faction	false
effect_bundles_localised_description_3k_dlc06_faction_yunnan_chen_wen_effect	You are allied with this faction.	false
effect_bundles_localised_title_3k_dlc07_faction_chen_deng_chen_wen_effect	Allied with Chen Deng's Faction	false
effect_bundles_localised_description_3k_dlc07_faction_chen_deng_chen_wen_effect	You are allied with this faction.	false
effect_bundles_localised_title_3k_dlc07_faction_li_shu_chen_wen_effect	Allied with Li Shu's Faction	false
effect_bundles_localised_description_3k_dlc07_faction_li_shu_chen_wen_effect	You are allied with this faction.	false
effect_bundles_localised_title_3k_dlc07_faction_shanyue_rebels_chen_wen_effect	Allied with Shanyue Rebels' Faction	false
effect_bundles_localised_description_3k_dlc07_faction_shanyue_rebels_chen_wen_effect	You are allied with this faction.	false
effect_bundles_localised_title_3k_dlc07_faction_shi_hui_chen_wen_effect	Allied with Shi Hui's Faction	false
effect_bundles_localised_description_3k_dlc07_faction_shi_hui_chen_wen_effect	You are allied with this faction.	false
effect_bundles_localised_title_3k_dlc07_faction_yuan_xi_chen_wen_effect	Allied with Yuan Xi's Faction	false
effect_bundles_localised_description_3k_dlc07_faction_yuan_xi_chen_wen_effect	You are allied with this faction.	false
effect_bundles_localised_title_3k_dlc07_faction_zhang_lu_chen_wen_effect	Allied with Zhang Lu's Faction	false
effect_bundles_localised_description_3k_dlc07_faction_zhang_lu_chen_wen_effect	You are allied with this faction.	false
effect_bundles_localised_title_3k_dlc07_faction_zhang_meng_chen_wen_effect	Allied with Zhang Meng's Faction	false
effect_bundles_localised_description_3k_dlc07_faction_zhang_meng_chen_wen_effect	You are allied with this faction.	false
effect_bundles_localised_title_3k_dlc07_faction_zhang_xiu_chen_wen_effect	Allied with Zhang Xiu's Faction	false
effect_bundles_localised_description_3k_dlc07_faction_zhang_xiu_chen_wen_effect	You are allied with this faction.	false
effect_bundles_localised_title_3k_main_faction_anding_chen_wen_effect	Allied with Anding's Faction	false
effect_bundles_localised_description_3k_main_faction_anding_chen_wen_effect	You are allied with this faction.	false
effect_bundles_localised_title_3k_main_faction_anping_chen_wen_effect	Allied with Anping's Faction	false
effect_bundles_localised_description_3k_main_faction_anping_chen_wen_effect	You are allied with this faction.	false
effect_bundles_localised_title_3k_main_faction_ba_chen_wen_effect	Allied with Ba's Faction	false
effect_bundles_localised_description_3k_main_faction_ba_chen_wen_effect	You are allied with this faction.	false
effect_bundles_localised_title_3k_main_faction_badong_chen_wen_effect	Allied with Badong's Faction	false
effect_bundles_localised_description_3k_main_faction_badong_chen_wen_effect	You are allied with this faction.	false
effect_bundles_localised_title_3k_main_faction_baxi_chen_wen_effect	Allied with Baxi's Faction	false
effect_bundles_localised_description_3k_main_faction_baxi_chen_wen_effect	You are allied with this faction.	false
effect_bundles_localised_title_3k_main_faction_beihai_chen_wen_effect	Allied with Beihai's Faction	false
effect_bundles_localised_description_3k_main_faction_beihai_chen_wen_effect	You are allied with this faction.	false
effect_bundles_localised_title_3k_main_faction_bohai_chen_wen_effect	Allied with Bohai's Faction	false
effect_bundles_localised_description_3k_main_faction_bohai_chen_wen_effect	You are allied with this faction.	false
effect_bundles_localised_title_3k_main_faction_cai_mao_chen_wen_effect	Allied with Cai Mao's Faction	false
effect_bundles_localised_description_3k_main_faction_cai_mao_chen_wen_effect	You are allied with this faction.	false
effect_bundles_localised_title_3k_main_faction_cangwu_chen_wen_effect	Allied with Cangwu's Faction	false
effect_bundles_localised_description_3k_main_faction_cangwu_chen_wen_effect	You are allied with this faction.	false
effect_bundles_localised_title_3k_main_faction_cao_cao_chen_wen_effect	Allied with Cao Cao's Faction	false
effect_bundles_localised_description_3k_main_faction_cao_cao_chen_wen_effect	You are allied with this faction.	false
effect_bundles_localised_title_3k_main_faction_changan_chen_wen_effect	Allied with Changan's Faction	false
effect_bundles_localised_description_3k_main_faction_changan_chen_wen_effect	You are allied with this faction.	false
effect_bundles_localised_title_3k_main_faction_changsha_chen_wen_effect	Allied with Changsha's Faction	false
effect_bundles_localised_description_3k_main_faction_changsha_chen_wen_effect	You are allied with this faction.	false
effect_bundles_localised_title_3k_main_faction_chen_chen_wen_effect	Allied with Chen's Faction	false
effect_bundles_localised_description_3k_main_faction_chen_chen_wen_effect	You are allied with this faction.	false
effect_bundles_localised_title_3k_main_faction_chengdu_chen_wen_effect	Allied with Chengdu's Faction	false
effect_bundles_localised_description_3k_main_faction_chengdu_chen_wen_effect	You are allied with this faction.	false
effect_bundles_localised_title_3k_main_faction_daijun_chen_wen_effect	Allied with Daijun's Faction	false
effect_bundles_localised_description_3k_main_faction_daijun_chen_wen_effect	You are allied with this faction.	false
effect_bundles_localised_title_3k_main_faction_dong_zhuo_chen_wen_effect	Allied with Dong Zhuo's Faction	false
effect_bundles_localised_description_3k_main_faction_dong_zhuo_chen_wen_effect	You are allied with this faction.	false
effect_bundles_localised_title_3k_main_faction_donghai_chen_wen_effect	Allied with Donghai's Faction	false
effect_bundles_localised_description_3k_main_faction_donghai_chen_wen_effect	You are allied with this faction.	false
effect_bundles_localised_title_3k_main_faction_dongjun_chen_wen_effect	Allied with Dongjun's Faction	false
effect_bundles_localised_description_3k_main_faction_dongjun_chen_wen_effect	You are allied with this faction.	false
effect_bundles_localised_title_3k_main_faction_donglai_chen_wen_effect	Allied with Donglai's Faction	false
effect_bundles_localised_description_3k_main_faction_donglai_chen_wen_effect	You are allied with this faction.	false
effect_bundles_localised_title_3k_main_faction_dongou_chen_wen_effect	Allied with Dongou's Faction	false
effect_bundles_localised_description_3k_main_faction_dongou_chen_wen_effect	You are allied with this faction.	false
effect_bundles_localised_title_3k_main_faction_fuling_chen_wen_effect	Allied with Fuling's Faction	false
effect_bundles_localised_description_3k_main_faction_fuling_chen_wen_effect	You are allied with this faction.	false
effect_bundles_localised_title_3k_main_faction_gao_gan_chen_wen_effect	Allied with Gao Gan's Faction	false
effect_bundles_localised_description_3k_main_faction_gao_gan_chen_wen_effect	You are allied with this faction.	false
effect_bundles_localised_title_3k_main_faction_gaoliang_chen_wen_effect	Allied with Gaoliang's Faction	false
effect_bundles_localised_description_3k_main_faction_gaoliang_chen_wen_effect	You are allied with this faction.	false
effect_bundles_localised_title_3k_main_faction_gongsun_du_chen_wen_effect	Allied with Gongsun Du's Faction	false
effect_bundles_localised_description_3k_main_faction_gongsun_du_chen_wen_effect	You are allied with this faction.	false
effect_bundles_localised_title_3k_main_faction_gongsun_zan_chen_wen_effect	Allied with Gongsun Zan's Faction	false
effect_bundles_localised_description_3k_main_faction_gongsun_zan_chen_wen_effect	You are allied with this faction.	false
effect_bundles_localised_title_3k_main_faction_guangling_chen_wen_effect	Allied with Guangling's Faction	false
effect_bundles_localised_description_3k_main_faction_guangling_chen_wen_effect	You are allied with this faction.	false
effect_bundles_localised_title_3k_main_faction_han_empire_chen_wen_effect	Allied with Han Empire's Faction	false
effect_bundles_localised_description_3k_main_faction_han_empire_chen_wen_effect	You are allied with this faction.	false
effect_bundles_localised_title_3k_main_faction_han_fu_chen_wen_effect	Allied with Han Fu's Faction	false
effect_bundles_localised_description_3k_main_faction_han_fu_chen_wen_effect	You are allied with this faction.	false
effect_bundles_localised_title_3k_main_faction_han_sui_chen_wen_effect	Allied with Han Sui's Faction	false
effect_bundles_localised_description_3k_main_faction_han_sui_chen_wen_effect	You are allied with this faction.	false
effect_bundles_localised_title_3k_main_faction_hanzhong_chen_wen_effect	Allied with Hanzhong's Faction	false
effect_bundles_localised_description_3k_main_faction_hanzhong_chen_wen_effect	You are allied with this faction.	false
effect_bundles_localised_title_3k_main_faction_hedong_chen_wen_effect	Allied with Hedong's Faction	false
effect_bundles_localised_description_3k_main_faction_hedong_chen_wen_effect	You are allied with this faction.	false
effect_bundles_localised_title_3k_main_faction_henei_chen_wen_effect	Allied with Henei's Faction	false
effect_bundles_localised_description_3k_main_faction_henei_chen_wen_effect	You are allied with this faction.	false
effect_bundles_localised_title_3k_main_faction_huang_zu_chen_wen_effect	Allied with Huang Zu's Faction	false
effect_bundles_localised_description_3k_main_faction_huang_zu_chen_wen_effect	You are allied with this faction.	false
effect_bundles_localised_title_3k_main_faction_jia_long_chen_wen_effect	Allied with Jia Long's Faction	false
effect_bundles_localised_description_3k_main_faction_jia_long_chen_wen_effect	You are allied with this faction.	false
effect_bundles_localised_title_3k_main_faction_jianan_chen_wen_effect	Allied with Jianan's Faction	false
effect_bundles_localised_description_3k_main_faction_jianan_chen_wen_effect	You are allied with this faction.	false
effect_bundles_localised_title_3k_main_faction_jiangxia_chen_wen_effect	Allied with Jiangxia's Faction	false
effect_bundles_localised_description_3k_main_faction_jiangxia_chen_wen_effect	You are allied with this faction.	false
effect_bundles_localised_title_3k_main_faction_jiangyang_chen_wen_effect	Allied with Jiangyang's Faction	false
effect_bundles_localised_description_3k_main_faction_jiangyang_chen_wen_effect	You are allied with this faction.	false
effect_bundles_localised_title_3k_main_faction_jianning_chen_wen_effect	Allied with Jianning's Faction	false
effect_bundles_localised_description_3k_main_faction_jianning_chen_wen_effect	You are allied with this faction.	false
effect_bundles_localised_title_3k_main_faction_jianye_chen_wen_effect	Allied with Jianye's Faction	false
effect_bundles_localised_description_3k_main_faction_jianye_chen_wen_effect	You are allied with this faction.	false
effect_bundles_localised_title_3k_main_faction_jiaozhi_chen_wen_effect	Allied with Jiaozhi's Faction	false
effect_bundles_localised_description_3k_main_faction_jiaozhi_chen_wen_effect	You are allied with this faction.	false
effect_bundles_localised_title_3k_main_faction_jincheng_chen_wen_effect	Allied with Jincheng's Faction	false
effect_bundles_localised_description_3k_main_faction_jincheng_chen_wen_effect	You are allied with this faction.	false
effect_bundles_localised_title_3k_main_faction_jingzhou_chen_wen_effect	Allied with Jingzhou's Faction	false
effect_bundles_localised_description_3k_main_faction_jingzhou_chen_wen_effect	You are allied with this faction.	false
effect_bundles_localised_title_3k_main_faction_kong_rong_chen_wen_effect	Allied with Kong Rong's Faction	false
effect_bundles_localised_description_3k_main_faction_kong_rong_chen_wen_effect	You are allied with this faction.	false
effect_bundles_localised_title_3k_main_faction_kong_zhou_chen_wen_effect	Allied with Kong Zhou's Faction	false
effect_bundles_localised_description_3k_main_faction_kong_zhou_chen_wen_effect	You are allied with this faction.	false
effect_bundles_localised_title_3k_main_faction_kuaiji_chen_wen_effect	Allied with Kuaiji's Faction	false
effect_bundles_localised_description_3k_main_faction_kuaiji_chen_wen_effect	You are allied with this faction.	false
effect_bundles_localised_title_3k_main_faction_langye_chen_wen_effect	Allied with Langye's Faction	false
effect_bundles_localised_description_3k_main_faction_langye_chen_wen_effect	You are allied with this faction.	false
effect_bundles_localised_title_3k_main_faction_lingling_chen_wen_effect	Allied with Lingling's Faction	false
effect_bundles_localised_description_3k_main_faction_lingling_chen_wen_effect	You are allied with this faction.	false
effect_bundles_localised_title_3k_main_faction_liu_bei_chen_wen_effect	Allied with Liu Bei's Faction	false
effect_bundles_localised_description_3k_main_faction_liu_bei_chen_wen_effect	You are allied with this faction.	false
effect_bundles_localised_title_3k_main_faction_liu_biao_chen_wen_effect	Allied with Liu Biao's Faction	false
effect_bundles_localised_description_3k_main_faction_liu_biao_chen_wen_effect	You are allied with this faction.	false
effect_bundles_localised_title_3k_main_faction_liu_dai_chen_wen_effect	Allied with Liu Dai's Faction	false
effect_bundles_localised_description_3k_main_faction_liu_dai_chen_wen_effect	You are allied with this faction.	false
effect_bundles_localised_title_3k_main_faction_liu_yan_chen_wen_effect	Allied with Liu Yan's Faction	false
effect_bundles_localised_description_3k_main_faction_liu_yan_chen_wen_effect	You are allied with this faction.	false
effect_bundles_localised_title_3k_main_faction_liu_yao_chen_wen_effect	Allied with Liu Yao's Faction	false
effect_bundles_localised_description_3k_main_faction_liu_yao_chen_wen_effect	You are allied with this faction.	false
effect_bundles_localised_title_3k_main_faction_liu_yu_chen_wen_effect	Allied with Liu Yu's Faction	false
effect_bundles_localised_description_3k_main_faction_liu_yu_chen_wen_effect	You are allied with this faction.	false
effect_bundles_localised_title_3k_main_faction_lu_bu_chen_wen_effect	Allied with Lu Bu's Faction	false
effect_bundles_localised_description_3k_main_faction_lu_bu_chen_wen_effect	You are allied with this faction.	false
effect_bundles_localised_title_3k_main_faction_lu_zhi_chen_wen_effect	Allied with Lu Zhi's Faction	false
effect_bundles_localised_description_3k_main_faction_lu_zhi_chen_wen_effect	You are allied with this faction.	false
effect_bundles_localised_title_3k_main_faction_lujiang_chen_wen_effect	Allied with Lujiang's Faction	false
effect_bundles_localised_description_3k_main_faction_lujiang_chen_wen_effect	You are allied with this faction.	false
effect_bundles_localised_title_3k_main_faction_luling_chen_wen_effect	Allied with Luling's Faction	false
effect_bundles_localised_description_3k_main_faction_luling_chen_wen_effect	You are allied with this faction.	false
effect_bundles_localised_title_3k_main_faction_luoyang_chen_wen_effect	Allied with Luoyang's Faction	false
effect_bundles_localised_description_3k_main_faction_luoyang_chen_wen_effect	You are allied with this faction.	false
effect_bundles_localised_title_3k_main_faction_ma_teng_chen_wen_effect	Allied with Ma Teng's Faction	false
effect_bundles_localised_description_3k_main_faction_ma_teng_chen_wen_effect	You are allied with this faction.	false
effect_bundles_localised_title_3k_main_faction_nanhai_chen_wen_effect	Allied with Nanhai's Faction	false
effect_bundles_localised_description_3k_main_faction_nanhai_chen_wen_effect	You are allied with this faction.	false
effect_bundles_localised_title_3k_main_faction_nanyang_chen_wen_effect	Allied with Nanyang's Faction	false
effect_bundles_localised_description_3k_main_faction_nanyang_chen_wen_effect	You are allied with this faction.	false
effect_bundles_localised_title_3k_main_faction_penchang_chen_wen_effect	Allied with Penchang's Faction	false
effect_bundles_localised_description_3k_main_faction_penchang_chen_wen_effect	You are allied with this faction.	false
effect_bundles_localised_title_3k_main_faction_pingyuan_chen_wen_effect	Allied with Pingyuan's Faction	false
effect_bundles_localised_description_3k_main_faction_pingyuan_chen_wen_effect	You are allied with this faction.	false
effect_bundles_localised_title_3k_main_faction_poyang_chen_wen_effect	Allied with Poyang's Faction	false
effect_bundles_localised_description_3k_main_faction_poyang_chen_wen_effect	You are allied with this faction.	false
effect_bundles_localised_title_3k_main_faction_rebels_chen_wen_effect	Allied with Rebels' Faction	false
effect_bundles_localised_description_3k_main_faction_rebels_chen_wen_effect	You are allied with this faction.	false
effect_bundles_localised_title_3k_main_faction_runan_chen_wen_effect	Allied with Runan's Faction	false
effect_bundles_localised_description_3k_main_faction_runan_chen_wen_effect	You are allied with this faction.	false
effect_bundles_localised_title_3k_main_faction_shangdang_chen_wen_effect	Allied with Shangdang's Faction	false
effect_bundles_localised_description_3k_main_faction_shangdang_chen_wen_effect	You are allied with this faction.	false
effect_bundles_localised_title_3k_main_faction_shangyong_chen_wen_effect	Allied with Shangyong's Faction	false
effect_bundles_localised_description_3k_main_faction_shangyong_chen_wen_effect	You are allied with this faction.	false
effect_bundles_localised_title_3k_main_faction_shi_xie_chen_wen_effect	Allied with Shi Xie's Faction	false
effect_bundles_localised_description_3k_main_faction_shi_xie_chen_wen_effect	You are allied with this faction.	false
effect_bundles_localised_title_3k_main_faction_shoufang_chen_wen_effect	Allied with Shoufang's Faction	false
effect_bundles_localised_description_3k_main_faction_shoufang_chen_wen_effect	You are allied with this faction.	false
effect_bundles_localised_title_3k_main_faction_sun_jian_chen_wen_effect	Allied with Sun Jian's Faction	false
effect_bundles_localised_description_3k_main_faction_sun_jian_chen_wen_effect	You are allied with this faction.	false
effect_bundles_localised_title_3k_main_faction_taishan_chen_wen_effect	Allied with Taishan's Faction	false
effect_bundles_localised_description_3k_main_faction_taishan_chen_wen_effect	You are allied with this faction.	false
effect_bundles_localised_title_3k_main_faction_taiyuan_chen_wen_effect	Allied with Taiyuan's Faction	false
effect_bundles_localised_description_3k_main_faction_taiyuan_chen_wen_effect	You are allied with this faction.	false
effect_bundles_localised_title_3k_main_faction_tao_qian_chen_wen_effect	Allied with Tao Qian's Faction	false
effect_bundles_localised_description_3k_main_faction_tao_qian_chen_wen_effect	You are allied with this faction.	false
effect_bundles_localised_title_3k_main_faction_tong'an_chen_wen_effect	Allied with Tong'an's Faction	false
effect_bundles_localised_description_3k_main_faction_tong'an_chen_wen_effect	You are allied with this faction.	false
effect_bundles_localised_title_3k_main_faction_wang_kuang_chen_wen_effect	Allied with Wang Kuang's Faction	false
effect_bundles_localised_description_3k_main_faction_wang_kuang_chen_wen_effect	You are allied with this faction.	false
effect_bundles_localised_title_3k_main_faction_wang_lang_chen_wen_effect	Allied with Wang Lang's Faction	false
effect_bundles_localised_description_3k_main_faction_wang_lang_chen_wen_effect	You are allied with this faction.	false
effect_bundles_localised_title_3k_main_faction_weijun_chen_wen_effect	Allied with Weijun's Faction	false
effect_bundles_localised_description_3k_main_faction_weijun_chen_wen_effect	You are allied with this faction.	false
effect_bundles_localised_title_3k_main_faction_wudu_chen_wen_effect	Allied with Wudu's Faction	false
effect_bundles_localised_description_3k_main_faction_wudu_chen_wen_effect	You are allied with this faction.	false
effect_bundles_localised_title_3k_main_faction_wuling_chen_wen_effect	Allied with Wuling's Faction	false
effect_bundles_localised_description_3k_main_faction_wuling_chen_wen_effect	You are allied with this faction.	false
effect_bundles_localised_title_3k_main_faction_wuwei_chen_wen_effect	Allied with Wuwei's Faction	false
effect_bundles_localised_description_3k_main_faction_wuwei_chen_wen_effect	You are allied with this faction.	false
effect_bundles_localised_title_3k_main_faction_xiangyang_chen_wen_effect	Allied with Xiangyang's Faction	false
effect_bundles_localised_description_3k_main_faction_xiangyang_chen_wen_effect	You are allied with this faction.	false
effect_bundles_localised_title_3k_main_faction_xihe_chen_wen_effect	Allied with Xihe's Faction	false
effect_bundles_localised_description_3k_main_faction_xihe_chen_wen_effect	You are allied with this faction.	false
effect_bundles_localised_title_3k_main_faction_xindu_chen_wen_effect	Allied with Xindu's Faction	false
effect_bundles_localised_description_3k_main_faction_xindu_chen_wen_effect	You are allied with this faction.	false
effect_bundles_localised_title_3k_main_faction_yangzhou_chen_wen_effect	Allied with Yangzhou's Faction	false
effect_bundles_localised_description_3k_main_faction_yangzhou_chen_wen_effect	You are allied with this faction.	false
effect_bundles_localised_title_3k_main_faction_yanmen_chen_wen_effect	Allied with Yanmen's Faction	false
effect_bundles_localised_description_3k_main_faction_yanmen_chen_wen_effect	You are allied with this faction.	false
effect_bundles_localised_title_3k_main_faction_ye_chen_wen_effect	Allied with Ye's Faction	false
effect_bundles_localised_description_3k_main_faction_ye_chen_wen_effect	You are allied with this faction.	false
effect_bundles_localised_title_3k_main_faction_yellow_turban_anding_chen_wen_effect	Allied with Gong Du's Faction	false
effect_bundles_localised_description_3k_main_faction_yellow_turban_anding_chen_wen_effect	You are allied with this faction.	false
effect_bundles_localised_title_3k_main_faction_yellow_turban_generic_chen_wen_effect	Allied with the Yellow Turbans	false
effect_bundles_localised_description_3k_main_faction_yellow_turban_generic_chen_wen_effect	You are allied with this faction.	false
effect_bundles_localised_title_3k_main_faction_yellow_turban_rebels_chen_wen_effect	Allied with He Yi's Faction	false
effect_bundles_localised_description_3k_main_faction_yellow_turban_rebels_chen_wen_effect	You are allied with this faction.	false
effect_bundles_localised_title_3k_main_faction_yellow_turban_taishan_chen_wen_effect	Allied with Huang Shao's Faction	false
effect_bundles_localised_description_3k_main_faction_yellow_turban_taishan_chen_wen_effect	You are allied with this faction.	false
effect_bundles_localised_title_3k_main_faction_yingchuan_chen_wen_effect	Allied with Yingchuan's Faction	false
effect_bundles_localised_description_3k_main_faction_yingchuan_chen_wen_effect	You are allied with this faction.	false
effect_bundles_localised_title_3k_main_faction_yizhou_chen_wen_effect	Allied with Yizhou's Faction	false
effect_bundles_localised_description_3k_main_faction_yizhou_chen_wen_effect	You are allied with this faction.	false
effect_bundles_localised_title_3k_main_faction_youbeiping_chen_wen_effect	Allied with Youbeiping's Faction	false
effect_bundles_localised_description_3k_main_faction_youbeiping_chen_wen_effect	You are allied with this faction.	false
effect_bundles_localised_title_3k_main_faction_youzhou_chen_wen_effect	Allied with Youzhou's Faction	false
effect_bundles_localised_description_3k_main_faction_youzhou_chen_wen_effect	You are allied with this faction.	false
effect_bundles_localised_title_3k_main_faction_yu_chen_wen_effect	Allied with Yu's Faction	false
effect_bundles_localised_description_3k_main_faction_yu_chen_wen_effect	You are allied with this faction.	false
effect_bundles_localised_title_3k_main_faction_chen_wen_chen_wen_effect	Allied with Yuan Shao's Faction	false
effect_bundles_localised_description_3k_main_faction_chen_wen_chen_wen_effect	You are allied with this faction.	false
effect_bundles_localised_title_3k_main_faction_yuan_shu_chen_wen_effect	Allied with Yuan Shu's Faction	false
effect_bundles_localised_description_3k_main_faction_yuan_shu_chen_wen_effect	You are allied with this faction.	false
effect_bundles_localised_title_3k_main_faction_yulin_chen_wen_effect	Allied with Yulin's Faction	false
effect_bundles_localised_description_3k_main_faction_yulin_chen_wen_effect	You are allied with this faction.	false
effect_bundles_localised_title_3k_main_faction_yuzhang_chen_wen_effect	Allied with Yuzhang's Faction	false
effect_bundles_localised_description_3k_main_faction_yuzhang_chen_wen_effect	You are allied with this faction.	false
effect_bundles_localised_title_3k_main_faction_zangke_chen_wen_effect	Allied with Zangke's Faction	false
effect_bundles_localised_description_3k_main_faction_zangke_chen_wen_effect	You are allied with this faction.	false
effect_bundles_localised_title_3k_main_faction_zhai_rong_chen_wen_effect	Allied with Zhai Rong's Faction	false
effect_bundles_localised_description_3k_main_faction_zhai_rong_chen_wen_effect	You are allied with this faction.	false
effect_bundles_localised_title_3k_main_faction_zhang_chao_chen_wen_effect	Allied with Zhang Chao's Faction	false
effect_bundles_localised_description_3k_main_faction_zhang_chao_chen_wen_effect	You are allied with this faction.	false
effect_bundles_localised_title_3k_main_faction_zhang_lu_chen_wen_effect	Allied with Zhang Lu's Faction	false
effect_bundles_localised_description_3k_main_faction_zhang_lu_chen_wen_effect	You are allied with this faction.	false
effect_bundles_localised_title_3k_main_faction_zhang_yan_chen_wen_effect	Allied with Zhang Yan's Faction	false
effect_bundles_localised_description_3k_main_faction_zhang_yan_chen_wen_effect	You are allied with this faction.	false
effect_bundles_localised_title_3k_main_faction_zhang_yang_chen_wen_effect	Allied with Zhang Yang's Faction	false
effect_bundles_localised_description_3k_main_faction_zhang_yang_chen_wen_effect	You are allied with this faction.	false
effect_bundles_localised_title_3k_main_faction_zheng_jiang_chen_wen_effect	Allied with Zheng Jiang's Faction	false
effect_bundles_localised_description_3k_main_faction_zheng_jiang_chen_wen_effect	You are allied with this faction.	false
effect_bundles_localised_title_3k_main_faction_zhongshan_chen_wen_effect	Allied with Zhongshan's Faction	false
effect_bundles_localised_description_3k_main_faction_zhongshan_chen_wen_effect	You are allied with this faction.	false
effect_bundles_localised_title_ironic_faction_wuhuan_tribes_chen_wen_effect	Allied with Wuhuan Tribes' Faction	false
effect_bundles_localised_description_ironic_faction_wuhuan_tribes_chen_wen_effect	You are allied with this faction.	false
effect_bundles_localised_title_ironic_faction_xiongnu_tribes_chen_wen_effect	Allied with Xiongnu Tribes' Faction	false
effect_bundles_localised_description_ironic_faction_xiongnu_tribes_chen_wen_effect	You are allied with this faction.	false
effect_bundles_localised_title_ironic_faction_zhuge_xuan_chen_wen_effect	Allied with Zhuge Xuan's Faction	false
effect_bundles_localised_description_ironic_faction_zhuge_xuan_chen_wen_effect	You are allied with this faction.	false
effect_bundles_localised_title_ironic_faction_zhang_jin_chen_wen_effect	Allied with Zhang Jin's Faction	false
effect_bundles_localised_description_ironic_faction_zhang_jin_chen_wen_effect	You are allied with this faction.	false
effect_bundles_localised_title_ironic_faction_zhang_xian_chen_wen_effect	Allied with Zhang Xian's Faction	false
effect_bundles_localised_description_ironic_faction_zhang_xian_chen_wen_effect	You are allied with this faction.	false
effect_bundles_localised_title_ironic_faction_liu_pan_chen_wen_effect	Allied with Liu Pan's Faction	false
effect_bundles_localised_description_ironic_faction_liu_pan_chen_wen_effect	You are allied with this faction.	false
effect_bundles_localised_title_ironic_faction_zhu_hao_chen_wen_effect	Allied with Zhu Hao's Faction	false
effect_bundles_localised_description_ironic_faction_zhu_hao_chen_wen_effect	You are allied with this faction.	false
effect_bundles_localised_title_ironic_faction_bian_rang_chen_wen_effect	Allied with Bian Rang's Faction	false
effect_bundles_localised_description_ironic_faction_bian_rang_chen_wen_effect	You are allied with this faction.	false
effect_bundles_localised_title_ironic_faction_chen_wen_chen_wen_effect	Allied with Chen Wen's Faction	false
effect_bundles_localised_description_ironic_faction_chen_wen_chen_wen_effect	You are allied with this faction.	false
effect_bundles_localised_title_ironic_faction_gan_ning_chen_wen_effect	Allied with Gan Ning's Faction	false
effect_bundles_localised_description_ironic_faction_gan_ning_chen_wen_effect	You are allied with this faction.	false
effect_bundles_localised_title_ironic_faction_goguryeo_chen_wen_effect	Allied with Goguryeo's Faction	false
effect_bundles_localised_description_ironic_faction_goguryeo_chen_wen_effect	You are allied with this faction.	false
effect_bundles_localised_title_ironic_faction_bakaja_chen_wen_effect	Allied with Bakaja's Faction	false
effect_bundles_localised_description_ironic_faction_bakaja_chen_wen_effect	You are allied with this faction.	false
effect_bundles_localised_title_ironic_faction_shitla_chen_wen_effect	Allied with Shitla's Faction	false
effect_bundles_localised_description_ironic_faction_shitla_chen_wen_effect	You are allied with this faction.	false
effect_bundles_localised_title_ironic_faction_tamno_chen_wen_effect	Allied with Tamno's Faction	false
effect_bundles_localised_description_ironic_faction_tamno_chen_wen_effect	You are allied with this faction.	false
effect_bundles_localised_title_ironic_faction_gaya_chen_wen_effect	Allied with Gaya's Faction	false
effect_bundles_localised_description_ironic_faction_gaya_chen_wen_effect	You are allied with this faction.	false
effect_bundles_localised_title_ironic_faction_buyeo_chen_wen_effect	Allied with Buyeo's Faction	false
effect_bundles_localised_description_ironic_faction_buyeo_chen_wen_effect	You are allied with this faction.	false
effect_bundles_localised_title_ironic_faction_korea_ye_chen_wen_effect	Allied with Korea Ye's Faction	false
effect_bundles_localised_description_ironic_faction_korea_ye_chen_wen_effect	You are allied with this faction.	false
effect_bundles_localised_title_ironic_faction_zhang_jin_border_chen_wen_effect	Allied with Zhang Jin Border's Faction	false
effect_bundles_localised_description_ironic_faction_zhang_jin_border_chen_wen_effect	You are allied with this faction.	false
effect_bundles_localised_title_ironic_faction_ma_ai_chen_wen_effect	Allied with Ma Ai's Faction	false
effect_bundles_localised_description_ironic_faction_ma_ai_chen_wen_effect	You are allied with this faction.	false
effect_bundles_localised_title_ironic_faction_huang_clan_chen_wen_effect	Allied with Huang Clan's Faction	false
effect_bundles_localised_description_ironic_faction_huang_clan_chen_wen_effect	You are allied with this faction.	false
effect_bundles_localised_title_ironic_faction_wang_sheng_chen_wen_effect	Allied with Wang Sheng's Faction	false
effect_bundles_localised_description_ironic_faction_wang_sheng_chen_wen_effect	You are allied with this faction.	false
effect_bundles_localised_title_ironic_faction_tong_zhi_chen_wen_effect	Allied with Tong Zhi's Faction	false
effect_bundles_localised_description_ironic_faction_tong_zhi_chen_wen_effect	You are allied with this faction.	false
effect_bundles_localised_title_ironic_faction_hu_mao_chen_wen_effect	Allied with Hu Mao's Faction	false
effect_bundles_localised_description_ironic_faction_hu_mao_chen_wen_effect	You are allied with this faction.	false
effect_bundles_localised_title_3k_main_faction_yuan_shao_chen_wen_effect	Allied with Yuan Shao's Faction	false
effect_bundles_localised_description_3k_main_faction_yuan_shao_chen_wen_effect	You are allied with this faction.	false
effect_bundles_localised_title_ironic_faction_xianbei_kuitou_chen_wen_effect	Allied with Kuitou's Faction	false
effect_bundles_localised_description_ironic_faction_xianbei_kuitou_chen_wen_effect	You are allied with this faction.	false
effect_bundles_localised_title_ironic_faction_xianbei_tuoba_chen_wen_effect	Allied with Tuoba Jiefan's Faction	false
effect_bundles_localised_description_ironic_faction_xianbei_tuoba_chen_wen_effect	You are allied with this faction.	false
effect_bundles_localised_title_ironic_faction_di_tribes_chen_wen_effect	Allied with Dou Mao's Faction	false
effect_bundles_localised_description_ironic_faction_di_tribes_chen_wen_effect	You are allied with this faction.	false
