key	text	tooltip
#Loc;1;text/db/factions/faction_kingdom_names.loc		
campaign_group_faction_cosmetic_overrides_name_3k_dlc05_campaign_group_cosmetic_tag_faction_name_hua_xin_4	Kingdom of Ran 	false
campaign_group_faction_cosmetic_overrides_name_3k_dlc05_campaign_group_cosmetic_tag_faction_name_hua_xin_separatists_3	Duchy of Ran 	false
campaign_group_faction_cosmetic_overrides_name_3k_dlc05_campaign_group_cosmetic_tag_faction_name_hua_xin_separatists_world_leader	Kingdom of Ran 	false
campaign_group_faction_cosmetic_overrides_name_3k_dlc05_campaign_group_cosmetic_tag_faction_name_hua_xin_world_leader	Kingdom of Ran 	false
campaign_group_faction_cosmetic_overrides_name_3k_dlc05_campaign_group_cosmetic_tag_faction_name_hua_xin_separatists_4	Kingdom of Ran 	false
campaign_group_faction_cosmetic_overrides_name_3k_dlc05_campaign_group_cosmetic_tag_faction_name_hua_xin_3	Duchy of Ran 	false
campaign_group_faction_cosmetic_overrides_name_3k_dlc05_campaign_group_cosmetic_tag_faction_name_wu_jing_separatists_world_leader	Kingdom of Nanwu 	false
campaign_group_faction_cosmetic_overrides_name_3k_dlc05_campaign_group_cosmetic_tag_faction_name_wu_jing_world_leader	Kingdom of Nanwu 	false
campaign_group_faction_cosmetic_overrides_name_3k_dlc05_campaign_group_cosmetic_tag_faction_name_wu_jing_separatists_4	Kingdom of Nanwu 	false
campaign_group_faction_cosmetic_overrides_name_3k_dlc05_campaign_group_cosmetic_tag_faction_name_wu_jing_4	Kingdom of Nanwu 	false
campaign_group_faction_cosmetic_overrides_name_3k_dlc05_campaign_group_cosmetic_tag_faction_name_wu_jing_3	Duchy of Nanwu 	false
campaign_group_faction_cosmetic_overrides_name_3k_dlc05_campaign_group_cosmetic_tag_faction_name_wu_jing_separatists_3	Duchy of Nanwu	false
campaign_group_faction_cosmetic_overrides_name_ironic_campaign_group_member_cosmetic_tag_faction_name_wuhuan_world_leader	Kingdom of Huxia	false
campaign_group_faction_cosmetic_overrides_name_ironic_campaign_group_member_cosmetic_tag_faction_name_wuhuan_3	Duchy of Huxia	false
campaign_group_faction_cosmetic_overrides_name_ironic_campaign_group_member_cosmetic_tag_faction_name_wuhuan_4	Kingdom of Huxia	false
campaign_group_faction_cosmetic_overrides_name_ironic_campaign_group_member_cosmetic_tag_faction_name_xiongnu_world_leader	Kingdom of Han Zhao	false
campaign_group_faction_cosmetic_overrides_name_ironic_campaign_group_member_cosmetic_tag_faction_name_xiongnu_3	Duchy of Han Zhao	false
campaign_group_faction_cosmetic_overrides_name_ironic_campaign_group_member_cosmetic_tag_faction_name_xiongnu_4	Kingdom of Han Zhao	false
campaign_group_faction_cosmetic_overrides_name_ironic_campaign_group_member_cosmetic_tag_faction_name_di_world_leader	Kingdom of Qiuchi	false
campaign_group_faction_cosmetic_overrides_name_ironic_campaign_group_member_cosmetic_tag_faction_name_di_3	Duchy of Qiuchi	false
campaign_group_faction_cosmetic_overrides_name_ironic_campaign_group_member_cosmetic_tag_faction_name_di_4	Kingdom of Qiuchi  	false
campaign_group_faction_cosmetic_overrides_name_ironic_campaign_group_member_cosmetic_tag_faction_name_xianbei_kuitou_world_leader	Kingdom of Tuyuhun	false
campaign_group_faction_cosmetic_overrides_name_ironic_campaign_group_member_cosmetic_tag_faction_name_xianbei_kuitou_3	Duchy of Tuyuhun	false
campaign_group_faction_cosmetic_overrides_name_ironic_campaign_group_member_cosmetic_tag_faction_name_xianbei_kuitou_4	Kingdom of Tuyuhun	false
campaign_group_faction_cosmetic_overrides_name_ironic_campaign_group_member_cosmetic_tag_faction_name_xianbei_tuoba_world_leader	Kingdom of Northern Wei	false
campaign_group_faction_cosmetic_overrides_name_ironic_campaign_group_member_cosmetic_tag_faction_name_xianbei_tuoba_3	Duchy of Northern Wei	false
campaign_group_faction_cosmetic_overrides_name_ironic_campaign_group_member_cosmetic_tag_faction_name_xianbei_tuoba_4	Kingdom of Northern Wei	false
campaign_group_faction_cosmetic_overrides_name_3k_main_campaign_group_cosmetic_tag_faction_name_sheng_xian_separatists_world_leader	Kingdom of Ying Separatists	false
campaign_group_faction_cosmetic_overrides_name_3k_main_campaign_group_cosmetic_tag_faction_name_sheng_xian_3	Duchy of Ying 	false
campaign_group_faction_cosmetic_overrides_name_3k_main_campaign_group_cosmetic_tag_faction_name_sheng_xian_world_leader	Kingdom of Ying 	false
campaign_group_faction_cosmetic_overrides_name_3k_main_campaign_group_cosmetic_tag_faction_name_sheng_xian_separatists_4	Kingdom of Ying Separatists	false
campaign_group_faction_cosmetic_overrides_name_3k_main_campaign_group_cosmetic_tag_faction_name_sheng_xian_4	Kingdom of Ying	false
campaign_group_faction_cosmetic_overrides_name_3k_main_campaign_group_cosmetic_tag_faction_name_sheng_xian_separatists_3	Duchy of Ying Separatists	false
campaign_group_faction_cosmetic_overrides_name_3k_dlc04_campaign_group_cosmetic_tag_faction_name_liu_xun_4	Kingdom of Zhan	false
campaign_group_faction_cosmetic_overrides_name_3k_dlc04_campaign_group_cosmetic_tag_faction_name_liu_xun_separatists_3	Duchy of Zhan Separatists	false
campaign_group_faction_cosmetic_overrides_name_3k_dlc04_campaign_group_cosmetic_tag_faction_name_liu_xun_separatists_world_leader	Kingdom of Zhan Separatists	false
campaign_group_faction_cosmetic_overrides_name_3k_dlc04_campaign_group_cosmetic_tag_faction_name_liu_xun_3	Duchy of Zhan	false
campaign_group_faction_cosmetic_overrides_name_3k_dlc04_campaign_group_cosmetic_tag_faction_name_liu_xun_separatists_4	Kingdom of Zhan Separatists	false
campaign_group_faction_cosmetic_overrides_name_3k_dlc04_campaign_group_cosmetic_tag_faction_name_liu_xun_world_leader	Kingdom of Zhan	false
campaign_group_faction_cosmetic_overrides_name_ironic_campaign_group_member_cosmetic_tag_faction_name_cao_ren_world_leader	Kingdom of 	false
campaign_group_faction_cosmetic_overrides_name_ironic_campaign_group_member_cosmetic_tag_faction_name_cao_ren_3	Duchy of 	false
campaign_group_faction_cosmetic_overrides_name_ironic_campaign_group_member_cosmetic_tag_faction_name_cao_ren_4	Kingdom of 	false
campaign_group_faction_cosmetic_overrides_name_ironic_campaign_group_member_cosmetic_tag_faction_name_ma_chao_world_leader	Kingdom of 	false
campaign_group_faction_cosmetic_overrides_name_ironic_campaign_group_member_cosmetic_tag_faction_name_ma_chao_3	Duchy of 	false
campaign_group_faction_cosmetic_overrides_name_ironic_campaign_group_member_cosmetic_tag_faction_name_ma_chao_4	Kingdom of 	false
campaign_group_faction_cosmetic_overrides_name_ironic_campaign_group_member_cosmetic_tag_faction_name_sun_quan_world_leader	Kingdom of 	false
campaign_group_faction_cosmetic_overrides_name_ironic_campaign_group_member_cosmetic_tag_faction_name_sun_quan_3	Duchy of 	false
campaign_group_faction_cosmetic_overrides_name_ironic_campaign_group_member_cosmetic_tag_faction_name_sun_quan_4	Kingdom of 	false
campaign_group_faction_cosmetic_overrides_name_ironic_campaign_group_member_cosmetic_tag_faction_name_xiahou_yuan_world_leader	Kingdom of 	false
campaign_group_faction_cosmetic_overrides_name_ironic_campaign_group_member_cosmetic_tag_faction_name_xiahou_yuan_3	Duchy of 	false
campaign_group_faction_cosmetic_overrides_name_ironic_campaign_group_member_cosmetic_tag_faction_name_xiahou_yuan_4	Kingdom of 	false
campaign_group_faction_cosmetic_overrides_name_ironic_campaign_group_member_cosmetic_tag_faction_name_zhang_liao_world_leader	Kingdom of 	false
campaign_group_faction_cosmetic_overrides_name_ironic_campaign_group_member_cosmetic_tag_faction_name_zhang_liao_3	Duchy of 	false
campaign_group_faction_cosmetic_overrides_name_ironic_campaign_group_member_cosmetic_tag_faction_name_zhang_liao_4	Kingdom of 	false
campaign_group_faction_cosmetic_overrides_name_ironic_campaign_group_member_cosmetic_tag_faction_name_chen_lan_world_leader	Kingdom of 	false
campaign_group_faction_cosmetic_overrides_name_ironic_campaign_group_member_cosmetic_tag_faction_name_chen_lan_3	Duchy of 	false
campaign_group_faction_cosmetic_overrides_name_ironic_campaign_group_member_cosmetic_tag_faction_name_chen_lan_4	Kingdom of 	false
campaign_group_faction_cosmetic_overrides_name_ironic_campaign_group_member_cosmetic_tag_faction_name_zhou_yu_world_leader	Kingdom of 	false
campaign_group_faction_cosmetic_overrides_name_ironic_campaign_group_member_cosmetic_tag_faction_name_zhou_yu_3	Duchy of 	false
campaign_group_faction_cosmetic_overrides_name_ironic_campaign_group_member_cosmetic_tag_faction_name_zhou_yu_4	Kingdom of 	false
campaign_group_faction_cosmetic_overrides_name_ironic_campaign_group_member_cosmetic_tag_faction_name_zhong_yao_world_leader	Kingdom of 	false
campaign_group_faction_cosmetic_overrides_name_ironic_campaign_group_member_cosmetic_tag_faction_name_zhong_yao_3	Duchy of 	false
campaign_group_faction_cosmetic_overrides_name_ironic_campaign_group_member_cosmetic_tag_faction_name_zhong_yao_4	Kingdom of 	false
campaign_group_faction_cosmetic_overrides_name_ironic_campaign_group_member_cosmetic_tag_faction_name_du_ji_world_leader	Kingdom of 	false
campaign_group_faction_cosmetic_overrides_name_ironic_campaign_group_member_cosmetic_tag_faction_name_du_ji_3	Duchy of 	false
campaign_group_faction_cosmetic_overrides_name_ironic_campaign_group_member_cosmetic_tag_faction_name_du_ji_4	Kingdom of 	false
campaign_group_faction_cosmetic_overrides_name_ironic_campaign_group_member_cosmetic_tag_faction_name_zhuge_liang_world_leader	Kingdom of 	false
campaign_group_faction_cosmetic_overrides_name_ironic_campaign_group_member_cosmetic_tag_faction_name_zhuge_liang_3	Duchy of 	false
campaign_group_faction_cosmetic_overrides_name_ironic_campaign_group_member_cosmetic_tag_faction_name_zhuge_liang_4	Kingdom of 	false
campaign_group_faction_cosmetic_overrides_name_ironic_campaign_group_member_cosmetic_tag_faction_name_zhao_fan_world_leader	Kingdom of Yi 	false
campaign_group_faction_cosmetic_overrides_name_ironic_campaign_group_member_cosmetic_tag_faction_name_zhao_fan_3	Duchy of Yi 	false
campaign_group_faction_cosmetic_overrides_name_ironic_campaign_group_member_cosmetic_tag_faction_name_zhao_fan_4	Kingdom of Yi 	false
campaign_group_faction_cosmetic_overrides_name_ironic_campaign_group_member_cosmetic_tag_faction_name_sun_ben_world_leader	Kingdom of 	false
campaign_group_faction_cosmetic_overrides_name_ironic_campaign_group_member_cosmetic_tag_faction_name_sun_ben_3	Duchy of 	false
campaign_group_faction_cosmetic_overrides_name_ironic_campaign_group_member_cosmetic_tag_faction_name_sun_ben_4	Kingdom of 	false
campaign_group_faction_cosmetic_overrides_name_ironic_campaign_group_member_cosmetic_tag_faction_name_lei_xu_world_leader	Kingdom of 	false
campaign_group_faction_cosmetic_overrides_name_ironic_campaign_group_member_cosmetic_tag_faction_name_lei_xu_3	Duchy of 	false
campaign_group_faction_cosmetic_overrides_name_ironic_campaign_group_member_cosmetic_tag_faction_name_lei_xu_4	Kingdom of 	false
campaign_group_faction_cosmetic_overrides_name_ironic_campaign_group_member_cosmetic_tag_faction_name_liu_shan_world_leader	Kingdom of 	false
campaign_group_faction_cosmetic_overrides_name_ironic_campaign_group_member_cosmetic_tag_faction_name_liu_shan_3	Duchy of 	false
campaign_group_faction_cosmetic_overrides_name_ironic_campaign_group_member_cosmetic_tag_faction_name_liu_shan_4	Kingdom of 	false
campaign_group_faction_cosmetic_overrides_name_ironic_campaign_group_member_cosmetic_tag_faction_name_guan_yu_world_leader	Kingdom of 	false
campaign_group_faction_cosmetic_overrides_name_ironic_campaign_group_member_cosmetic_tag_faction_name_guan_yu_3	Duchy of 	false
campaign_group_faction_cosmetic_overrides_name_ironic_campaign_group_member_cosmetic_tag_faction_name_guan_yu_4	Kingdom of 	false
campaign_group_faction_cosmetic_overrides_name_ironic_campaign_group_member_cosmetic_tag_faction_name_zu_lang_world_leader	Kingdom of Wuyue 	false
campaign_group_faction_cosmetic_overrides_name_ironic_campaign_group_member_cosmetic_tag_faction_name_zu_lang_3	Duchy of Wuyue 	false
campaign_group_faction_cosmetic_overrides_name_ironic_campaign_group_member_cosmetic_tag_faction_name_zu_lang_4	Kingdom of Wuyue 	false
campaign_group_faction_cosmetic_overrides_name_ironic_campaign_group_member_cosmetic_tag_faction_name_zhu_jun_world_leader	Kingdom of 	false
campaign_group_faction_cosmetic_overrides_name_ironic_campaign_group_member_cosmetic_tag_faction_name_zhu_jun_3	Duchy of 	false
campaign_group_faction_cosmetic_overrides_name_ironic_campaign_group_member_cosmetic_tag_faction_name_zhu_jun_4	Kingdom of 	false
campaign_group_faction_cosmetic_overrides_name_ironic_campaign_group_member_cosmetic_tag_faction_name_han_xuan_world_leader	Kingdom of 	false
campaign_group_faction_cosmetic_overrides_name_ironic_campaign_group_member_cosmetic_tag_faction_name_han_xuan_3	Duchy of 	false
campaign_group_faction_cosmetic_overrides_name_ironic_campaign_group_member_cosmetic_tag_faction_name_han_xuan_4	Kingdom of 	false
campaign_group_faction_cosmetic_overrides_name_ironic_campaign_group_member_cosmetic_tag_faction_name_you_tu_world_leader	Kingdom of Ouyue 	false
campaign_group_faction_cosmetic_overrides_name_ironic_campaign_group_member_cosmetic_tag_faction_name_you_tu_3	Duchy of Ouyue 	false
campaign_group_faction_cosmetic_overrides_name_ironic_campaign_group_member_cosmetic_tag_faction_name_you_tu_4	Kingdom of Ouyue 	false
campaign_group_faction_cosmetic_overrides_name_ironic_campaign_group_member_cosmetic_tag_faction_name_fei_zhan_world_leader	Kingdom of Minyue 	false
campaign_group_faction_cosmetic_overrides_name_ironic_campaign_group_member_cosmetic_tag_faction_name_fei_zhan_3	Duchy of Minyue 	false
campaign_group_faction_cosmetic_overrides_name_ironic_campaign_group_member_cosmetic_tag_faction_name_fei_zhan_4	Kingdom of Minyue 	false
campaign_group_faction_cosmetic_overrides_name_ironic_campaign_group_member_cosmetic_tag_faction_name_zhao_wei_world_leader	Kingdom of Yi 	false
campaign_group_faction_cosmetic_overrides_name_ironic_campaign_group_member_cosmetic_tag_faction_name_zhao_wei_3	Duchy of Yi 	false
campaign_group_faction_cosmetic_overrides_name_ironic_campaign_group_member_cosmetic_tag_faction_name_zhao_wei_4	Kingdom of Yi 	false
campaign_group_faction_cosmetic_overrides_name_ironic_campaign_group_member_cosmetic_tag_faction_name_su_dai_world_leader	Kingdom of Xiong 	false
campaign_group_faction_cosmetic_overrides_name_ironic_campaign_group_member_cosmetic_tag_faction_name_su_dai_3	Duchy of Xiong 	false
campaign_group_faction_cosmetic_overrides_name_ironic_campaign_group_member_cosmetic_tag_faction_name_su_dai_4	Kingdom of Xiong 	false
campaign_group_faction_cosmetic_overrides_name_ironic_campaign_group_member_cosmetic_tag_faction_name_shanyue_world_leader	Kingdom of Dongou 	false
campaign_group_faction_cosmetic_overrides_name_ironic_campaign_group_member_cosmetic_tag_faction_name_shanyue_3	Duchy of Dongou 	false
campaign_group_faction_cosmetic_overrides_name_ironic_campaign_group_member_cosmetic_tag_faction_name_shanyue_4	Kingdom of Dongou 	false
